정류소명,정류소아이디,총승차건수,총하차건수,승차건수(카드),하차건수(카드),승차건수(현금),일평균승하차건수
(구)국제여객터미널,35051,29,1137,20,1137,9,37
(구)국제여객터미널,35052,1457,17,1451,17,6,47
(주)경동세라믹스,89146,598,23,598,23,0,20
(주)경인양행앞,42096,1002,848,1002,848,0,59
(주)경인양행앞,42097,1953,3833,1953,3833,0,186
(주)대한특수금속,39050,1120,67,1120,67,0,38
(주)두남,39135,232,53,232,53,0,9
(주)세모입구(린나이코리아),37585,1225,1862,1225,1862,0,99
(주)세모입구(린나이코리아),40893,411,719,411,719,0,36
(주)스킨이데아,89388,385,506,385,506,0,28
(주)스킨이데아,89389,2619,19,2619,19,0,85
(주)씨피엔텍,39133,474,3358,474,3358,0,123
(주)씨피엔텍,39134,2079,420,2079,420,0,80
(주)창원,39029,3366,2975,3366,2975,0,204
(주)창원,39030,3900,3543,3900,3543,0,240
(주)하나금속,39124,21,54,21,54,0,2
17사단.다임메가타운,40895,2109,4701,2109,4701,0,219
17사단입구,40832,12,516,5,516,7,17
2001아울렛,40154,3495,5274,3494,5274,1,282
2001아울렛,40159,30555,13326,30540,13326,15,1415
2001아울렛,40162,10648,21313,10642,21313,6,1031
2001아울렛부평점,40158,4713,2545,4713,2545,0,234
2차풍림아이원,42584,32,10981,32,10981,0,355
3단지,40736,198,1574,198,1574,0,57
3단지관리사무소,40107,1633,378,1633,378,0,64
41번구종점,42174,1872,5558,1872,5558,0,239
510번차고지,36145,893,355,893,355,0,40
540번종점,39470,3162,86,3135,86,27,104
6공단사거리,37577,270,2590,270,2590,0,92
6공단입구,37442,695,853,695,853,0,49
6공단입구,37443,1075,1667,1075,1667,0,88
8부두,35181,212,1838,212,1838,0,66
8부두,35182,1282,2939,1281,2939,1,136
CJ인천2공장,35591,427,3161,425,3161,2,115
CJ인천2공장,35592,2326,112,2325,112,1,78
E편한세상,42453,3154,2118,3152,2118,2,170
E편한세상,42649,1491,3615,1490,3615,1,164
E편한세상,42726,3652,1715,3644,1715,8,173
GM물류센터,40568,516,1178,516,1178,0,54
GS25편의점,36142,1032,2334,1027,2334,5,108
GS내리주유소,44130,0,7,0,7,0,0
GS내리주유소,44147,0,1,0,1,0,0
GS칼텍스,35168,656,62,655,62,1,23
GS칼텍스,35557,8,2208,8,2208,0,71
GS칼텍스,89220,135,561,135,561,0,22
GS칼텍스,89224,172,1378,172,1378,0,50
GS칼텍스주유소,39814,189,22,189,22,0,6
HD현대인프라코어,36081,650,1662,650,1662,0,74
HD현대인프라코어,36083,2429,921,2429,921,0,108
HD현대인프라코어후문,36077,5,864,5,864,0,28
HD현대인프라코어후문,36078,3869,603,3866,603,3,144
JC회관,37383,4227,4280,4227,4280,0,274
JST기술연구소,89491,1,1753,1,1753,0,56
JST기술연구소,89492,511,38,504,38,7,17
KCC아파트,42391,2117,1369,2115,1369,2,112
KG스틸,42008,2501,4482,2499,4482,2,225
KTX광명역4번출구,58057,2453,19,2453,19,0,79
KT부평지사,40381,10354,6854,10297,6854,57,555
KT부평지사,40384,7492,13000,7487,13000,5,661
KT서인천지사,42932,1696,2671,1696,2671,0,140
KT서인천지사,42933,1736,996,1736,996,0,88
KT송도지점,38568,803,457,803,457,0,40
KT온수분국,43523,646,203,643,203,3,27
KT인천공항지사,35095,235,38,235,38,0,8
KT인천공항지사,35109,6820,3080,6810,3080,10,319
KT인천지사,37415,6311,4591,6302,4591,9,351
KT인천지사,39319,8313,4661,8300,4661,13,418
KT중동지사,55081,835,181,835,181,0,32
KT중동지사,55082,165,1045,165,1045,0,39
LG마그나,89029,5951,2736,5951,2736,0,280
LG마그나,89264,2809,5323,2809,5323,0,262
LG물류센터,39043,343,151,343,151,0,15
LG물류센터,39044,84,515,84,515,0,19
LG전자(주),42297,4690,4351,4690,4351,0,291
LH1단지,35494,9444,4155,9440,4155,4,438
LH1단지,35495,4954,6606,4954,6606,0,372
LH49단지행복주택아파트,35768,760,1461,760,1461,0,71
LH49단지행복주택아파트,35769,1993,890,1993,890,0,93
LH7단지,35451,3602,2114,3602,2114,0,184
LH7단지,35452,2275,3678,2275,3678,0,192
LH미추홀3단지,37222,3077,6372,3041,6372,36,304
LH미추홀3단지,37635,6524,2785,6513,2785,11,300
LH웨스턴블루힐정문,89184,1655,3810,1655,3810,0,176
LH웨스턴블루힐정문,89185,4259,3551,4257,3551,2,251
NKG물류센터,89212,226,40,226,40,0,8
SK.GS주유소,89230,1334,1507,1332,1507,2,91
SK.GS주유소,89231,1762,2014,1762,2014,0,121
SKLPG충전사업소,35636,775,19,769,19,6,25
SKLPG충전사업소,35638,14,715,0,715,14,23
SK뷰아파트,42888,1345,5079,1345,5079,0,207
SK뷰아파트,42889,7009,1091,7009,1091,0,261
SK스카이뷰,37601,329,29773,329,29773,0,971
SK스카이뷰104동,37587,6922,52,6922,52,0,224
SK스카이뷰109동,37607,7557,71,7557,71,0,246
SK인천석유화학,42767,1265,675,1265,675,0,62
SK인천석유화학,42768,376,755,376,755,0,36
SK주유소,42956,486,494,486,494,0,31
SK주유소앞,35287,1511,129,1508,129,3,52
SK주유소앞,35539,70,1358,70,1358,0,46
SK충전소,35085,27,2161,21,2161,6,70
e편한세상 정문,38624,20973,1577,20959,1577,14,727
e편한세상(109동 앞),32062,811,1438,811,1438,0,72
e편한세상(109동앞),38643,1088,509,1088,509,0,51
e편한세상1차(정문),35662,577,976,577,976,0,50
e편한세상1차(정문),35663,1455,540,1455,540,0,64
e편한세상계양,41037,13975,3655,13957,3655,18,568
e편한세상계양,41038,5484,14307,5475,14307,9,638
e편한세상부평그랑힐스정문,40928,4356,615,4356,615,0,160
e편한세상부평그랑힐스정문,40929,481,5945,481,5945,0,207
e편한세상부평그랑힐스후문,40930,4791,389,4791,389,0,167
e편한세상영종센텀베뉴정문,35510,1317,4339,1317,4339,0,182
e편한세상영종오션하임,35674,1733,655,1733,655,0,77
e편한세상영종오션하임,35761,705,1557,705,1557,0,72
e편한세상영종하늘도시,35646,566,551,566,551,0,36
e편한세상영종하늘도시,35647,234,408,234,408,0,20
gym80fitness,37081,2600,902,2587,902,13,112
가경공원,89365,1106,601,1106,601,0,55
가구단지사거리,37455,2837,3560,2837,3560,0,206
가구단지사거리,37456,2875,2091,2871,2091,4,160
가구전시장,42072,349,598,349,598,0,30
가구전시장,42074,843,490,843,490,0,43
가나안마을앞,43904,2,15,1,15,1,0
가나안마을앞,43905,35,0,35,0,0,1
가능포,43969,6,8,5,8,1,0
가능포,43970,4,13,3,13,1,0
가림고등학교,42078,13539,13269,13498,13269,41,864
가야,42807,1127,5,1127,5,0,36
가야,42808,6,1436,6,1436,0,46
가오대입구,80033,130,435,126,435,4,18
가오대입구,80034,101,718,100,718,1,26
가원초등학교,42952,6228,4419,6224,4419,4,343
가원초등학교,89118,2611,5641,2611,5641,0,266
가재우물터,35678,6,14,6,14,0,0
가재우물터,35700,4,10,4,10,0,0
가재울사거리,42039,2403,5499,2401,5499,2,254
가재울사거리,42042,8745,4959,8735,4959,10,442
가재울역,42034,2432,3068,2426,3068,6,177
가재울역,42035,3593,2058,3570,2058,23,182
가정(루원시티)역,89050,6896,54311,6896,54311,0,1974
가정(루원시티)역,89051,74442,9389,74442,9389,0,2704
가정(루원시티)역,89075,75350,88662,75323,88662,27,5290
가정(루원시티)역,89078,82655,71477,82646,71477,9,4972
가정3동성당,42226,353,3218,353,3218,0,115
가정LH3단지정문앞,89041,18765,4325,18746,4325,19,744
가정고등학교,42200,11989,4403,11912,4403,77,528
가정고등학교,42203,3284,7766,3276,7766,8,356
가정교,89502,142,1312,142,1312,0,46
가정교,89503,2210,338,2210,338,0,82
가정교차로,89390,469,915,469,915,0,44
가정교차로,89391,298,2450,298,2450,0,88
가정동성당,89102,3547,3961,3545,3961,2,242
가정동성당,89105,2465,1617,2465,1617,0,131
가정보금자리,89119,1624,680,1624,680,0,74
가정보금자리,89120,155,1512,155,1512,0,53
가정여자중학교,42041,855,7858,830,7858,25,281
가정여중입구,89303,966,843,956,843,10,58
가정중앙시장역,42215,1269,1606,1269,1606,0,92
가정중앙시장역,42219,1177,1624,1177,1624,0,90
가정택지삼거리,89385,319,131,319,131,0,14
가정택지삼거리,89386,200,516,200,516,0,23
가정휴먼시아3단지,89186,870,1492,870,1492,0,76
가정휴먼시아3단지,89187,1324,963,1324,963,0,73
가좌2동행정복지센터,42073,6152,334,6109,334,43,209
가좌2동행정복지센터,42076,122,5146,118,5146,4,169
가좌3동행정복지센터,42075,12419,13244,12388,13244,31,827
가좌4동행정복지센터,42062,4513,6470,4501,6470,12,354
가좌고등학교,42060,13955,11734,13925,11734,30,828
가좌고등학교,42061,5601,7949,5580,7949,21,437
가좌공단,42526,30,9186,29,9186,1,297
가좌공단,42945,7295,220,7293,220,2,242
가좌교회,42055,3253,7539,3252,7539,1,348
가좌교회,42057,3715,3533,3715,3533,0,233
가좌녹지공원,42029,1819,4121,1806,4121,13,191
가좌녹지공원,42030,2155,1608,2149,1608,6,121
가좌농협,42066,8437,6496,8405,6496,32,481
가좌농협,42067,5832,5739,5809,5739,23,373
가좌동차고,42939,2255,277,2209,277,46,81
가좌동차고지,42522,56,1060,39,1060,17,36
가좌두산위브104동앞,42090,4392,3184,4392,3184,0,244
가좌사거리,42043,17,248,14,248,3,8
가좌사거리,42044,552,4878,545,4878,7,175
가좌진주아파트,42100,14185,29346,14160,29346,25,1404
가좌체육공원,42058,7032,1099,7005,1099,27,262
가좌초등학교,42069,3872,4406,3872,4406,0,267
가좌초등학교,42070,4701,2487,4701,2487,0,231
가좌테니스장,37454,2092,1049,2092,1049,0,101
가좌테니스장,37457,765,1164,765,1164,0,62
가좌현대아파트,42130,8029,1957,8025,1957,4,322
가좌현대아파트,42133,687,8759,687,8759,0,304
가좌홈플러스(쌍마아파트),42101,11087,7290,11049,7290,38,592
가좌홈플러스(쌍마아파트),42103,7417,12373,7379,12373,38,638
가좌환경사업소,42631,7124,4215,7122,4215,2,365
가좌환경사업소 북측,89341,185,323,185,323,0,16
가좌환경사업소북측,89342,16,240,16,240,0,8
가천대학교,38270,1288,1084,1288,1084,0,76
가천대학교,38284,7881,3088,7881,3088,0,353
가천대학교(노인복지회관),38269,730,1187,730,1187,0,61
가천의대,43237,0,15,0,15,0,0
가천의대,43897,7,4,6,4,1,0
가톨릭대,43156,0,1,0,1,0,0
가톨릭대,43325,0,63,0,63,0,2
가현오일뱅크,42734,43,13,43,13,0,1
가현중학교,42722,3171,3044,3166,3044,5,200
가현초교앞(루에블리아파트),89242,2245,3498,2245,3498,0,185
가현초교앞(센트럴타운아파트),89243,5048,1619,5048,1619,0,215
각곡,43602,2,123,2,123,0,4
각곡,43772,164,13,162,13,2,5
간석4거리,39538,207,263,205,263,2,15
간석4동새마을금고,39343,3294,6032,3287,6032,7,300
간석4동새마을금고,39346,3053,2671,3050,2671,3,184
간석4동행정복지센터,39403,3812,7423,3812,7423,0,362
간석4동행정복지센터,39412,4789,2656,4789,2656,0,240
간석금호어울림아파트,39334,25617,13516,25593,13516,24,1262
간석남부역,37429,4611,886,4611,886,0,177
간석남부역,37435,6911,2484,6880,2484,31,303
간석남부역,37529,1780,3631,1780,3631,0,174
간석동용광경로당,39394,866,573,844,573,22,46
간석래미안.자이,39333,16576,17642,16539,17642,37,1103
간석북부역,39806,4497,85,4497,85,0,147
간석북부역,39807,50,2972,50,2972,0,97
간석북부역·우성1차,39368,13060,4999,13060,4999,0,582
간석북부역·우성1차,39370,5596,10050,5596,10050,0,504
간석사거리,39413,13168,9506,13156,9506,12,731
간석사거리,39414,4964,9612,4961,9612,3,470
간석사거리,39430,2587,2505,2582,2505,5,164
간석사거리(상인천중학교),39422,12481,28163,12401,28163,80,1311
간석사거리(상인천중학교),39426,31845,19216,31782,19216,63,1647
간석시장,39434,12771,30066,12667,30066,104,1381
간석시장,39436,55632,31203,55521,31203,111,2801
간석시장,39437,15322,22309,15322,22309,0,1213
간석오거리,39460,16346,14049,16334,14049,12,980
간석오거리,39597,4278,3387,4277,3387,1,247
간석오거리(교원공제조합),39444,35918,29317,35887,29317,31,2104
간석오거리(인천웨딩홀),39406,7936,12386,7935,12386,1,655
간석오거리(인천웨딩홀),39423,33886,20427,33866,20427,20,1752
간석오거리역(7번출구),39447,16709,33533,16701,33533,8,1620
간석오거리역(8번출구),39449,61325,72614,61290,72614,35,4320
간석지구대,39535,685,634,673,634,12,42
간석지구대,39536,455,696,441,696,14,37
간석풍림아파트,92053,722,524,715,524,7,40
간석한신더휴아파트맞은편,37447,2587,532,2587,532,0,100
간재울초등학교,42347,5886,3655,5886,3655,0,307
간촌,43504,8,34,8,34,0,1
간촌,43518,56,13,56,13,0,2
갈산대동아파트,40550,310,737,310,737,0,33
갈산동아아파트,40567,1902,1663,1901,1663,1,115
갈산동입구,40622,39,3851,39,3851,0,125
갈산동천주교회,40652,846,5218,846,5218,0,195
갈산동천주교회맞은편,40650,6576,5334,6576,5334,0,384
갈산두산아파트,40544,4402,5689,4400,5689,2,325
갈산사거리,40631,2502,4835,2502,4835,0,236
갈산사거리,40634,3347,4783,3347,4783,0,262
갈산새마을금고,40635,8454,2139,8454,2139,0,341
갈산시장,40628,6572,6131,6572,6131,0,409
갈산시장.갈산도서관,40629,2287,5451,2287,5451,0,249
갈산역,40601,35560,11857,35556,11857,4,1529
갈산역,40602,9950,42888,9936,42888,14,1704
갈산역(1번출구),40604,22295,6646,22279,6646,16,933
갈산역(부평4공단)4번출구,40606,5836,16484,5826,16484,10,720
갈산주공1단지,40578,3001,2357,3001,2357,0,172
갈산주공1단지105동,40813,4076,2579,4076,2579,0,214
갈산주공2단지,40562,503,1321,503,1321,0,58
갈산주공2단지,40577,3934,7476,3929,7476,5,368
갈산태화아파트,40542,741,1074,741,1074,0,58
갈산태화아파트,40664,4437,820,4437,820,0,169
갈산태화아파트,40666,253,1630,253,1630,0,60
갈산태화아파트,40667,629,2663,629,2663,0,106
갈월초등학교,40531,132,1059,132,1059,0,38
갈현경로당,41491,29,318,29,318,0,11
갈현경로당앞,41607,214,41,214,41,0,8
갈현교,41608,18,2,18,2,0,0
갈현교,41609,2,17,2,17,0,0
갈현교입구,41492,235,29,235,29,0,8
갈현교입구,41617,21,202,21,202,0,7
갈현동마을,41351,734,660,734,660,0,44
갈현동마을,41352,233,1265,233,1265,0,48
갑곶돈대.강화전쟁박물관,43365,5,12,5,12,0,0
갑곶돈대.강화전쟁박물관,43728,0,21,0,21,0,0
갑곶돈대입구,43367,4,6,4,6,0,0
갑곶돈대입구,43726,13,8,13,8,0,0
갑륭초교,43374,3,0,3,0,0,0
갑륭초교,43724,7,178,7,178,0,5
갑문,35125,10,315,10,315,0,10
갑문,35504,151,26,151,26,0,5
강남시장,42172,18953,13486,18913,13486,40,1046
강남시장,42173,11895,11532,11872,11532,23,755
강남역도시에빛,31076,4839,6379,4839,6379,0,361
강남역서초현대타워앞,31016,44049,28141,44049,28141,0,2328
강남중교,43213,156,58,156,58,0,6
강남중교,43278,44,229,44,229,0,8
강서중학교,43660,8,139,7,139,1,4
강서중학교,43898,165,10,160,10,5,5
강인여객,40020,1060,1439,1060,1439,0,80
강인여객,40022,1212,874,1212,874,0,67
강화갯벌장어,43671,0,8,0,8,0,0
강화경찰서,43209,227,29,212,29,15,8
강화경찰서,43624,8,200,8,200,0,6
강화고등학교,43564,10,23,10,23,0,1
강화고등학교,43761,104,54,104,54,0,5
강화군 행복센터,43055,122,1795,119,1795,3,61
강화군 행복센터,43056,4,267,4,267,0,8
강화군노인문화센터,90373,7,31,7,31,0,1
강화군노인문화센터,90374,22,7,20,7,2,0
강화군청,43065,3749,881,3658,881,91,149
강화군청,43108,791,2807,777,2807,14,116
강화루지.강남상회,43150,118,76,114,76,4,6
강화루지.강남상회,43250,97,118,95,118,2,6
강화마니산,43001,37,71,37,71,0,3
강화마니산,43002,461,169,452,169,9,20
강화문화원.종합전시관,43097,0,44,0,44,0,1
강화문화원.종합전시관,43098,46,563,46,563,0,19
강화병원,43088,21,1570,21,1570,0,51
강화병원,43089,970,45,970,45,0,32
강화산단,90123,0,21,0,21,0,0
강화산단입구,90096,4,8,4,8,0,0
강화산단입구,90097,12,0,12,0,0,0
강화산성서문,43080,3,77,3,77,0,2
강화산성서문,43081,36,110,33,110,3,4
강화서문,43063,674,514,668,514,6,38
강화서문,43064,465,601,458,601,7,34
강화수양관앞,43467,70,29,70,29,0,3
강화수양관앞,43732,10,25,10,25,0,1
강화슈퍼,43066,551,1251,547,1251,4,58
강화슈퍼,43068,1671,476,1626,476,45,69
강화실버케어스앞,43975,19,141,19,141,0,5
강화실버케어스앞,43976,34,82,33,82,1,3
강화여자중학교,90334,0,18,0,18,0,0
강화역사박물관(고인돌),43601,268,33,266,33,2,9
강화역사박물관(고인돌),43670,15,458,14,458,1,15
강화장례식장,43918,1498,85,1480,85,18,51
강화장례식장,43946,38,1925,38,1925,0,63
강화중학교,43207,43,25,42,25,1,2
강화중학교,43623,11,59,10,59,1,2
강화터미널,43058,5,0,5,0,0,0
강화터미널,43096,49758,1346,48947,1346,811,1648
개항동 어울터,35197,8910,1811,8910,1811,0,345
개항동 어울터,35198,2047,8859,2047,8859,0,351
개화2치안센터,25023,29,1707,29,1707,0,56
개화2치안센터,25024,1895,29,1895,29,0,62
개화역1번출구.개화검문소,25030,138,6392,138,6392,0,210
개화역1번출구.개화검문소,25031,2271,243,2268,243,3,81
개화역광역환승센터,25182,1405,2339,1405,2339,0,120
갤러리84입구,35666,73,12,72,12,1,2
갤러리84입구,35667,11,76,11,76,0,2
갯벌슈퍼,43410,0,21,0,21,0,0
갯벌슈퍼,43513,7,3,7,3,0,0
거북시장,42132,12944,11277,12867,11277,77,781
거북시장,42136,11666,10672,11643,10672,23,720
거산정공.(주)록키,39137,1427,2026,1423,2026,4,111
거잠포선착장,35302,132,282,131,282,1,13
거잠포선착장,35303,237,134,235,134,2,11
거잠포회센터,35588,77,43,77,43,0,3
건설기술교육원,39353,6625,11800,6625,11800,0,594
건설기술교육원,39354,5453,4907,5453,4907,0,334
건영아파트,38069,16100,40894,16090,40894,10,1838
건일아파트,43015,451,266,445,266,6,23
건일아파트,43094,221,320,213,320,8,17
건지사거리,42882,80,0,80,0,0,2
건지사거리,42883,2,280,2,280,0,9
건평,43168,36,48,36,48,0,2
건평,43186,2,44,2,44,0,1
건평리,43187,42,6,42,6,0,1
건평리,43651,8,51,6,51,2,1
건평마을회관,43594,4,33,4,33,0,1
건평입구,43170,3,17,3,17,0,0
건평입구,43331,5,19,5,19,0,0
걸포북변역,35560,26,4622,26,4622,0,149
걸포북변역,35610,1763,78,1763,78,0,59
걸포사거리.우리병원,35561,191,225,191,225,0,13
검단1차피오레·금호어울림아파트,89457,377,205,377,205,0,18
검단1차피오레·금호어울림아파트,89458,49,633,49,633,0,22
검단LH행복주택,89408,12317,3740,12317,3740,0,517
검단공구상가,89053,50,707,50,707,0,24
검단공구상가,89065,490,223,490,223,0,23
검단노인복지관,42695,174,492,166,492,8,21
검단농기구센터,89316,108,3,104,3,4,3
검단농기구센터,89324,4,168,4,168,0,5
검단농협,42432,26596,9205,26580,9205,16,1154
검단농협,42434,5717,14526,5690,14526,27,653
검단대성베르힐,89467,2346,719,2346,719,0,98
검단동행정복지센터(검단고교),42441,3899,8482,3888,8482,11,399
검단동행정복지센터(검단고교),42445,4442,4499,4438,4499,4,288
검단디에트르리버파크,89476,1060,4387,1060,4387,0,175
검단디에트르리버파크,89477,3361,909,3361,909,0,137
검단로제비앙라포레,89483,2717,13,2717,13,0,88
검단로지스틱스파크,41339,1403,331,1399,331,4,55
검단로지스틱스파크,42395,271,2573,271,2573,0,91
검단메가박스,42383,1921,1733,1916,1733,5,117
검단메가박스,42384,497,1018,497,1018,0,48
검단모아미래도엘리트,89466,1465,4684,1465,4684,0,198
검단모아엘가그랑데아파트,42483,7599,1405,7599,1405,0,290
검단사거리역,42419,15973,14975,15945,14975,28,998
검단사거리역,42426,1958,8389,1947,8389,11,333
검단사거리역,42427,7524,2881,7496,2881,28,335
검단사거리역,42537,11541,13757,11514,13757,27,816
검단소방서,42428,1282,4733,1280,4733,2,194
검단소방서,42431,294,2272,294,2272,0,82
검단신도시우미린리버포레,89409,5565,11615,5565,11615,0,554
검단신안인스빌어반퍼스트,89511,2270,32,2270,32,0,74
검단신안인스빌어반퍼스트,89512,154,1449,154,1449,0,51
검단예미지트리플에듀아파트,89484,12,1113,12,1113,0,36
검단오류공단,42702,18,590,18,590,0,19
검단오류공단,42703,211,9,211,9,0,7
검단오류역,89057,6050,697,6043,697,7,217
검단오류역,89060,581,6111,579,6111,2,215
검단오류역우방아이유쉘,89067,663,1019,662,1019,1,54
검단오류역우방아이유쉘,89068,1230,399,1211,399,19,52
검단오류풍림아이원,89251,108,347,108,347,0,14
검단오류풍림아이원,89252,389,203,389,203,0,19
검단우미린파크뷰1단지,89499,1115,67,1115,67,0,38
검단우미린파크뷰1단지,89500,77,208,77,208,0,9
검단우미린파크뷰2단지,89469,5130,1641,5130,1641,0,218
검단우미린파크뷰2단지,89501,1898,3307,1898,3307,0,167
검단우방아이유쉘아파트,42688,238,377,236,377,2,19
검단원흥아파트,42400,1750,1045,1747,1045,3,90
검단원흥아파트,42401,1160,2554,1159,2554,1,119
검단지식산업센타,89054,7092,177,7077,177,15,234
검단지식산업센타,89063,216,4938,216,4938,0,166
검단초등학교,42475,8400,3700,8385,3700,15,390
검단초등학교,42482,3610,6114,3608,6114,2,313
검단초등학교,89332,110,133,110,133,0,7
검단초등학교,89333,116,203,114,203,2,10
검단출장소,42423,14650,11279,14650,11279,0,836
검단출장소,42424,4121,9673,4121,9673,0,444
검단탑종합병원,42877,474,571,474,571,0,33
검단하나아파트,42421,1857,501,1855,501,2,76
검단하나아파트,42422,325,386,324,386,1,22
검단힐스테이트5차아파트,42557,0,107,0,107,0,3
검단힐스테이트5차아파트,42558,154,592,154,592,0,24
검문소,43662,2,7,1,7,1,0
검문소,43812,2,81,2,81,0,2
검문소,90042,0,1,0,1,0,0
검문소,90043,6,113,6,113,0,3
검바위역,42348,4535,889,4529,889,6,174
검바위역,42349,1007,5075,1007,5075,0,196
검암경서동행정복지센터,42352,1664,5788,1664,5788,0,240
검암경서동행정복지센터,42353,6324,1639,6324,1639,0,256
검암사거리,42356,2479,3916,2477,3916,2,206
검암사거리,42357,5107,2280,5101,2280,6,238
검암사거리,42358,6269,1988,6269,1988,0,266
검암역(시내방면),42364,9569,394,9557,394,12,321
검암역(원당방면),42363,3909,26814,3895,26814,14,991
검암역.서해그랑블아파트,42360,5561,5693,5561,5693,0,363
검암역로열파크씨티푸르지오1단지,89167,11166,58,11105,58,61,362
검암역로열파크씨티푸르지오1단지,89168,47,9380,42,9380,5,304
검암역로열파크씨티푸르지오2단지,89169,572,51,572,51,0,20
검암역로열파크씨티푸르지오2단지,89170,24,5583,24,5583,0,180
검암역입구,42851,22019,8755,22015,8755,4,992
검암역입구,42852,10920,14226,10918,14226,2,811
검암역입구(시천교밑),89250,12105,3014,12105,3014,0,487
검암중학교,42359,3504,1719,3502,1719,2,168
검암중학교,42362,2118,2698,2117,2698,1,155
검암초등학교,42361,360,5517,360,5517,0,189
겐트대학교글로벌캠퍼스,38769,39,0,39,0,0,1
겐트대학교글로벌캠퍼스,38770,94,651,94,651,0,24
경기국제통상고.포도마을뉴서울.중앙공원,55042,597,1722,597,1722,0,74
경기국제통상고.포도마을뉴서울.중앙공원,55043,1237,948,1236,948,1,70
경기도교육청학생교육원,43162,0,90,0,90,0,2
경기도교육청학생교육원,43222,147,19,145,19,2,5
경기주유소,43051,97,365,96,365,1,14
경남1차,40343,8244,340,8180,340,64,276
경남1차아파트,40376,13464,7290,13453,7290,11,669
경남2차,40305,8652,65,8612,65,40,281
경남아너스빌,42099,2817,1396,2816,1396,1,135
경남아너스빌,42102,1320,2443,1319,2443,1,121
경남아너스빌아파트,42110,5349,3032,5348,3032,1,270
경남아너스빌아파트,42111,1778,2974,1775,2974,3,153
경남아파트,35143,7399,2596,7393,2596,6,322
경남아파트,35147,1611,3143,1600,3143,11,153
경남아파트,38281,8105,7293,8103,7293,2,496
경남아파트,41011,14846,3876,14819,3876,27,603
경남아파트,41014,4029,8193,4022,8193,7,394
경남아파트,42332,6684,3528,6684,3528,0,329
경남아파트,42334,3169,6580,3169,6580,0,314
경남아파트308동앞,40334,38,5815,34,5815,4,188
경남아파트311동앞,40300,15,5328,15,5328,0,172
경남아파트313동앞,40287,53,9358,29,9358,24,303
경동택배,89315,72,2,72,2,0,2
경동택배,89325,1,39,1,39,0,1
경명초등학교,89216,1518,498,1518,498,0,65
경명초등학교,89277,5015,7771,5015,7771,0,412
경명초등학교,89278,4141,6160,4141,6160,0,332
경방신약,39136,4459,1274,4459,1274,0,184
경방신약,39138,2587,8365,2587,8365,0,353
경복예식장,39399,10716,5134,10677,5134,39,511
경서농원,42333,222,579,222,579,0,25
경서농원,42335,79,1116,79,1116,0,38
경서지구입구,42303,1075,5856,1075,5856,0,223
경서지구입구,42671,2470,2664,2470,2664,0,165
경서지구입구,42672,4108,2988,4108,2988,0,228
경서초등학교,42569,4722,2756,4721,2756,1,241
경서초등학교,42570,2861,2898,2861,2898,0,185
경신마을,39646,193,150,193,150,0,11
경신마을,39982,105,925,105,925,0,33
경신아파트,41216,1730,902,1730,902,0,84
경신아파트,41223,1709,3419,1709,3419,0,165
경연초중학교,89271,7101,4446,7101,4446,0,372
경연초중학교,89272,3096,5896,3096,5896,0,290
경연초중학교·청라센텀로제비앙,89286,3012,1264,3012,1264,0,137
경연초중학교·호반베르디움6차,89285,2339,2203,2336,2203,3,146
경인계량소,42549,794,2,794,2,0,25
경인계량소,42550,0,615,0,615,0,19
경인교대.부평향교,41138,954,1088,954,1088,0,65
경인교대.부평향교,41139,992,831,992,831,0,58
경인교대역입구,41428,8449,6623,8449,6623,0,486
경인교대역입구,41429,7441,8747,7441,8747,0,522
경인교회앞,40077,842,3262,842,3262,0,132
경인방송,37003,151,107,151,107,0,8
경인방송,37004,42,339,42,339,0,12
경인산업,39688,664,1601,664,1601,0,73
경인아라뱃길여객터미널,42869,187,9,187,9,0,6
경인여대,41277,9111,14080,9111,14080,0,748
경인여대,41278,5574,6664,5574,6664,0,394
경인특장,42547,275,3,275,3,0,8
경인항다목적부두,89151,98,2,98,2,0,3
경인항다목적부두,89152,0,122,0,122,0,3
경전말,43934,37,0,35,0,2,1
경제자유구역청,38514,2056,2333,2056,2333,0,141
경제자유구역청,38515,2398,3778,2398,3778,0,199
경진브로아,39042,1014,1077,1014,1077,0,67
경흥빌라,43372,481,4,466,4,15,15
경흥빌라,43616,10,260,10,260,0,8
경희유치원앞,39991,147,515,147,515,0,21
경희유치원앞,39992,120,75,120,75,0,6
계량소,40195,2087,263,2079,263,8,75
계룡리슈빌,55225,4664,1115,4664,1115,0,186
계산공고,41167,3276,4236,3262,4236,14,242
계산공고,41170,5107,7877,5105,7877,2,418
계산공고앞,41169,2664,1872,2661,1872,3,146
계산국민체육센터,41276,1630,2730,1619,2730,11,140
계산국민체육센터,41613,1765,1998,1757,1998,8,121
계산동수협,41533,3777,4451,3777,4451,0,265
계산동아아파트,41231,258,3,258,3,0,8
계산동우체국,41427,7937,4025,7937,4025,0,385
계산삼거리,41196,359,260,359,260,0,19
계산삼거리(신도브래뉴),41199,10249,10028,10249,10028,0,654
계산삼거리(신도브래뉴),41201,4552,8237,4552,8237,0,412
계산시장,41176,3736,4455,3736,4455,0,264
계산여고,41576,650,748,645,748,5,45
계산여자고등학교,41221,27,335,27,335,0,11
계산여자고등학교,41224,889,1292,889,1292,0,70
계산역,41247,6293,4608,6284,4608,9,351
계산역,41371,5440,1536,5440,1536,0,225
계산역,41426,31529,21666,31528,21666,1,1715
계산역,41431,23710,31838,23710,31838,0,1791
계산우체국,41430,11082,12353,11082,12353,0,755
계산주공아파트,41423,12756,14101,12749,14101,7,866
계산중학교,41577,171,8,171,8,0,5
계양1동주민자치센터,41476,7360,1896,7360,1896,0,298
계양1동주민자치센터,41520,810,7961,810,7961,0,282
계양3동행정복지센터,41525,915,1273,915,1273,0,70
계양3동행정복지센터,41526,1083,768,1083,768,0,59
계양CGV,41140,4271,3707,4271,3707,0,257
계양경찰서,41184,10325,8854,10325,8854,0,618
계양경찰서,41185,6418,9156,6418,9156,0,502
계양경찰서,41195,20703,5385,20656,5385,47,841
계양경찰서·계양구청,41194,4427,16624,4410,16624,17,679
계양구의회,41123,5256,4891,5256,4891,0,327
계양구의회,41124,5167,5535,5166,5535,1,345
계양구청,41177,4228,3849,4228,3849,0,260
계양구청,41180,7039,9531,7037,9531,2,534
계양구청,41188,3657,1782,3650,1782,7,175
계양구청,41197,10,2477,10,2477,0,80
계양구청앞,41204,8426,4387,8388,4387,38,413
계양도서관,41251,5269,9248,5261,9248,8,468
계양문화회관,41248,1612,1169,1612,1169,0,89
계양문화회관,41255,2423,4156,2423,4156,0,212
계양산성박물관,41285,1138,1573,1138,1573,0,87
계양산성박물관,41286,741,1815,741,1815,0,82
계양산장미원 입구(계산동자연풀장),41186,917,1114,917,1114,0,65
계양산장미원 입구(계산동자연풀장),41189,646,1127,646,1127,0,57
계양산전통시장,41297,755,4559,754,4559,1,171
계양산전통시장,41298,4658,1449,4649,1449,9,197
계양산전통시장,41306,18350,17702,18332,17702,18,1162
계양산지구대,41281,912,1574,912,1574,0,80
계양산지구대,41282,1163,1399,1163,1399,0,82
계양새마을금고,41094,1387,1602,1381,1602,6,96
계양새마을금고,41097,1752,2181,1733,2181,19,126
계양세무서,41054,1511,1066,1508,1066,3,83
계양세무서,41058,872,1528,872,1528,0,77
계양센트레빌1단지,41550,4728,4693,4728,4693,0,303
계양센트레빌1단지,41627,1300,552,1300,552,0,59
계양센트레빌1단지,41628,170,799,170,799,0,31
계양센트레빌1단지(111동앞),41551,6228,4875,6228,4875,0,358
계양센트레빌2단지,41625,342,923,342,923,0,40
계양여성회관,41404,3541,4306,3541,4306,0,253
계양역,41357,188556,75458,188545,75458,11,8516
계양역,41358,65348,145148,65335,145148,13,6790
계양역(귤현역방면),41659,6605,281,6605,281,0,222
계양임광그대가아파트,41118,4163,303,4133,303,30,144
계양종합사회복지관,41120,508,1164,508,1164,0,53
계양종합사회복지관,41121,1203,581,1203,581,0,57
계양중학교,41340,2423,850,2421,850,2,105
계양중학교,41341,1640,7031,1640,7031,0,279
계양체육관(벨로드롬경기장),41666,335,1194,335,1194,0,49
계양체육관(아시아드양궁장),41454,635,905,635,905,0,49
계양체육관(아시아드양궁장),41455,2247,938,2245,938,2,102
계양체육관(아시아드양궁장),41567,3565,935,3565,935,0,145
계양체육관(아시아드양궁장),41568,1050,5503,1050,5503,0,211
계양체육관(효성해링턴플레이스),41440,3687,1193,3687,1193,0,157
계양체육관.대동아파트,41173,51,1558,51,1558,0,51
계양효성해링턴플레이스,41669,60,1819,60,1819,0,60
고구1리입구,90006,61,19,61,19,0,2
고구1리입구,90007,9,47,9,47,0,1
고구2리마을회관입구,90014,3,87,2,87,1,2
고구2리마을회관입구,90015,102,0,101,0,1,3
고구저수지,90008,9,19,9,19,0,0
고구저수지,90009,9,5,9,5,0,0
고구촌,90012,0,24,0,24,0,0
고구촌,90013,52,2,52,2,0,1
고능2리 종점,90372,24,22,20,22,4,1
고능2리능촌마을회관,90371,0,3,0,3,0,0
고능리공소,90208,97,100,93,100,4,6
고능리입구,43291,1,66,1,66,0,2
고능리입구,43534,68,1,67,1,1,2
고다니마을9단지,80362,128,65,127,65,1,6
고려산업,39486,742,1161,742,1161,0,61
고려양행,39111,1326,1519,1326,1519,0,91
고려저수지입구,43249,29,96,29,96,0,4
고려저수지입구,43486,73,30,72,30,1,3
고비고개정상,43569,6,2,6,2,0,0
고비고개정상,43844,2,28,2,28,0,0
고산마을입구,90016,2,22,2,22,0,0
고산마을입구,90017,51,10,50,10,1,1
고산촌,43544,237,70,237,70,0,9
고산촌,43779,114,210,108,210,6,10
고상골,43269,0,61,0,61,0,1
고상골,43382,74,5,74,5,0,2
고상골입구,43266,80,8,79,8,1,2
고상골입구,43552,14,100,14,100,0,3
고속터미널,31017,11447,313,11447,313,0,379
고속터미널,31018,665,19380,665,19380,0,646
고시기(가재골),43770,15,0,14,0,1,0
고시기(가재골),90126,0,9,0,9,0,0
고염나무골,35473,15,250,14,250,1,8
고염나무골,35474,306,30,305,30,1,10
고인돌입구,43550,0,25,0,25,0,0
고인돌체육관앞,90045,195,599,193,599,2,25
고인돌체육관앞,90046,662,218,659,218,3,28
고잔고등학교,39691,312,2688,312,2688,0,96
고잔마을,43284,68,0,64,0,4,2
고잔마을,43532,0,43,0,43,0,1
고창마을.KCC,80328,395,189,395,189,0,18
고창촌,43076,43,116,43,116,0,5
고창촌입구,43166,5,2,5,2,0,0
고창촌입구,43345,3,33,3,33,0,1
고천3리마을회관,43341,114,12,111,12,3,4
고천3리마을회관,43574,7,89,7,89,0,3
고천5리마을회관,90341,10,1,8,1,2,0
고천5리마을회관,90345,0,11,0,11,0,0
고천교,43339,38,78,37,78,1,3
고천교,43849,113,4,113,4,0,3
고천당,90420,4,5,4,5,0,0
고천당,90421,6,0,6,0,0,0
고촌역,80061,3427,738,3427,738,0,134
고촌역,80062,695,5834,695,5834,0,210
고합아파트,70036,173,142,173,142,0,10
고향산천,43464,12,12,12,12,0,0
고향산천,43610,27,20,27,20,0,1
곡촌,43427,26,32,26,32,0,1
곡촌,43457,54,17,53,17,1,2
곡촌,43789,59,56,56,56,3,3
곡촌,43816,2,75,2,75,0,2
곤능,43197,12,50,12,50,0,2
곤능,43319,40,2,40,2,0,1
골드클래스,42936,150,989,149,989,1,36
공개마을,90195,18,3,17,3,1,0
공개마을,90196,1,22,1,22,0,0
공구상가,36092,433,1823,433,1823,0,72
공구상가.간동입구,80021,1221,108,1220,108,1,42
공군8547부대앞,35718,46,64,46,64,0,3
공군8547부대앞,35719,5,145,5,145,0,4
공군회관,19255,165,1,165,1,0,5
공군회관,20107,13,334,13,334,0,11
공단공구상가,92048,0,15,0,15,0,0
공단공원앞,42739,199,237,199,237,0,14
공단공원앞,42740,323,104,323,104,0,13
공단본부,42270,251,835,251,835,0,35
공단본부,42756,2641,605,2641,605,0,104
공단본부,42757,682,2513,682,2513,0,103
공단사거리,42995,4,1037,4,1037,0,33
공단사거리,42996,1507,8,1507,8,0,48
공단사거리,89069,72,250,72,250,0,10
공단사거리,89070,254,605,254,605,0,27
공단소방서,39062,1487,3578,1487,3578,0,163
공단시장,37426,2563,5448,2563,5448,0,258
공단시장,37427,7429,3329,7429,3329,0,347
공단오거리,40565,1908,687,1905,687,3,83
공단오거리,40566,393,2619,392,2619,1,97
공단유통상가,42940,47,1015,47,1015,0,34
공단유통상가,42941,971,56,971,56,0,33
공단자동차,42022,1537,1927,1537,1927,0,111
공단치안센터,37444,1424,992,1424,992,0,77
공단치안센터,37445,322,1506,322,1506,0,58
공단회관,39119,1342,3534,1342,3534,0,157
공단회관,39123,2907,1186,2907,1186,0,132
공덕오거리,14149,515,3,515,3,0,16
공설운동장,43091,17,547,17,547,0,18
공설운동장,43092,248,104,240,104,8,11
공수부대입구,92069,97,79,97,79,0,5
공숙입구,43290,28,102,28,102,0,4
공숙입구,43490,42,88,42,88,0,4
공영산업,89148,19,822,19,822,0,27
공작아파트,39479,2048,3451,2039,3451,9,177
공작아파트,39480,3159,4728,3155,4728,4,254
공장단지입구,42555,325,67,325,67,0,12
공촌마을,42323,4459,3321,4456,3321,3,250
공촌마을,42598,2641,3925,2633,3925,8,211
공촌사거리,42324,18576,11152,18576,11152,0,958
공촌사거리,42330,16517,17715,16512,17715,5,1104
공촌사거리,42331,869,702,867,702,2,50
공촌사거리(한국아파트),42322,4120,5173,4120,5173,0,299
공촌유수지체육공원,89478,66,779,66,779,0,27
공촌유수지체육공원,89479,137,124,137,124,0,8
공촌정수장,42340,158,118,158,118,0,8
공촌정수장,42341,97,243,97,243,0,10
공항고등학교,35116,2692,784,2692,784,0,112
공항교회앞,35123,1851,2450,1848,2450,3,138
공항신도시(메디컬사거리),35258,864,1589,864,1589,0,79
공항중학교,35117,1259,1567,1259,1567,0,91
공항초등학교,35087,117,485,117,485,0,19
관곡마을,90104,0,16,0,16,0,0
관곡마을,90105,26,1,26,1,0,0
관광밸트입구,43874,1,1,1,1,0,0
관교노인복지관·승학초등학교,37679,960,1599,959,1599,1,82
관교여자중학교,37226,8980,8732,8961,8732,19,571
관교여자중학교,37229,2944,2381,2942,2381,2,171
관교여자중학교,37231,2886,3448,2881,3448,5,204
관교중학교,37200,338,986,338,986,0,42
관교중학교(약수터),37202,4530,7210,4517,7210,13,378
관교중학교(약수터),37203,10866,6265,10819,6265,47,552
관리공단본부,42720,574,79,574,79,0,21
관창마을,35252,1698,929,1698,929,0,84
관창마을,35253,1628,2227,1628,2227,0,124
광명아파트,37434,13769,6335,13769,6335,0,648
광명아파트,39348,6881,13745,6881,13745,0,665
광명아파트,39835,5,832,5,832,0,27
광명아파트,40590,2560,904,2560,904,0,111
광명아파트,40817,7967,1547,7961,1547,6,306
광명아파트,41096,629,2274,629,2274,0,93
광명아파트,41098,2484,916,2484,916,0,109
광명아파트,41108,14143,21112,14139,21112,4,1137
광명아파트,41448,2443,8831,2438,8831,5,363
광명역IC출입(미정차),53042,18,0,18,0,0,0
광명항,35708,66,5,66,5,0,2
광명항,35714,2006,1563,2002,1563,4,115
광명항(샘꾸미),35730,62,3,60,3,2,2
광성보,43674,21,99,21,99,0,3
광성오리,43128,13,0,13,0,0,0
광성오리,43862,0,37,0,37,0,1
광일아파트,40855,3564,1063,3564,1063,0,149
광일아파트,40874,2073,3752,2073,3752,0,187
교대역,31013,21335,21700,21335,21700,0,1388
교대입구,41141,1911,3193,1911,3193,0,164
교대입구,41142,3605,1817,3605,1817,0,174
교대후문,41362,1270,369,1270,369,0,52
교대후문,41363,287,2386,287,2386,0,86
교동중고후문,90024,3,53,3,53,0,1
교동중고후문,90025,114,4,111,4,3,3
교보생명,37357,31463,115089,31448,115089,15,4727
교산교회,43496,33,14,33,14,0,1
교산교회,43719,13,19,13,19,0,1
교산리입구,43694,30,32,27,32,3,2
교산리입구,43748,28,14,22,14,6,1
교산상회앞,43494,2,6,2,6,0,0
교산상회앞,43715,7,6,7,6,0,0
교육개발원입구,31005,853,11,853,11,0,27
교육개발원입구,31006,25,858,25,858,0,28
교통방송사거리,37538,952,2594,950,2594,2,114
교통방송사거리,37539,819,1203,819,1203,0,65
교통연수원,41191,707,2736,707,2736,0,111
교통연수원,41192,2583,1457,2583,1457,0,130
교회앞,43216,22,9,22,9,0,1
교회앞,43309,12,23,12,23,0,1
교회앞,43430,6,29,6,29,0,1
교회앞,43818,30,25,29,25,1,1
교회앞,90338,2,11,2,11,0,0
교회앞,90348,7,2,7,2,0,0
구검문소,43196,0,50,0,50,0,1
구검문소,43622,131,1,126,1,5,4
구능재,90193,34,11,32,11,2,1
구능재,90194,10,27,9,27,1,1
구도일주유소,40902,67,1175,64,1175,3,40
구두물입구,35219,296,319,296,319,0,19
구래리,80006,440,1583,437,1583,3,65
구래리,80007,1763,474,1757,474,6,72
구래역,80337,9942,20478,9935,20478,7,981
구래역,80338,22535,10092,22505,10092,30,1052
구렁목,43950,252,6,248,6,4,8
구렁목,43951,12,168,12,168,0,5
구름다리,35735,4,185,4,185,0,6
구름다리,35736,25,15,25,15,0,1
구반포역.세화고등학교,31031,1080,35,1080,35,0,35
구봉도입구,62035,31,349,31,349,0,12
구봉도입구,62037,346,45,346,45,0,12
구북성초교,43506,9,11,9,11,0,0
구북성초교,43656,8,11,8,11,0,0
구산사거리,40233,678,479,678,479,0,37
구산사거리,40842,389,21025,385,21025,4,690
구산사거리,40843,4112,7242,4100,7242,12,366
구산중학교,40518,778,962,778,962,0,56
구선택초교,43239,9,0,9,0,0,0
구선택초교,43896,0,5,0,5,0,0
구월1동행정복지센터,39967,866,2,866,2,0,28
구월1동행정복지센터,39981,1,375,1,375,0,12
구월2동행정복지센터,39586,3119,361,3119,361,0,112
구월2동행정복지센터,39607,340,2456,340,2456,0,90
구월도매전통시장,39192,21775,16398,21727,16398,48,1231
구월도매전통시장,39193,24706,34146,24691,34146,15,1898
구월동로데오거리,39195,4693,1028,4691,1028,2,184
구월동우체국,39211,3653,12897,3652,12897,1,533
구월동팬더아파트,39237,7928,8101,7911,8101,17,517
구월동팬더아파트,39238,9469,6632,9431,6632,38,519
구월서초등학교,39204,8388,6607,8387,6607,1,483
구월서초등학교,39205,5833,5893,5833,5893,0,378
구월아시아드1단지,39912,675,2,675,2,0,21
구월아시아드1단지,39913,0,115,0,115,0,3
구월아시아드5단지정문,39883,2579,5714,2566,5714,13,267
구월아시아드5단지후문,39881,2478,4568,2477,4568,1,227
구월아시아드6단지,39885,25237,8554,25235,8554,2,1090
구월아시아드6단지,39886,7873,19042,7872,19042,1,868
구월아시아드7단지,39892,3100,3979,3097,3979,3,228
구월아시아드8단지,39891,5229,2240,5223,2240,6,240
구월아시아드8단지,39948,58,499,58,499,0,17
구월아시아드8단지,39949,57,186,57,186,0,7
구월아시아드선수촌센트럴자이,39884,3996,2420,3988,2420,8,206
구월아시아드선수촌아파트,39202,845,744,845,744,0,51
구월아시아드선수촌아파트,39203,862,2006,862,2006,0,92
구월아시아드은빛호수공원,39914,9957,6728,9956,6728,1,538
구월아시아드은빛호수공원,39915,7666,6300,7665,6300,1,450
구월우체국,39213,8868,7088,8868,7088,0,514
구월중학교,39281,28886,19558,28835,19558,51,1562
구월중학교,39286,18800,29228,18776,29228,24,1549
구월체육공원,39384,3532,5147,3518,5147,14,279
구월초등학교,39832,1832,3732,1830,3732,2,179
구월초등학교,39833,3618,2123,3609,2123,9,185
구월한내들퍼스티지,39882,4495,1876,4494,1876,1,205
구장수파출소,39375,652,529,652,529,0,38
구재이,43282,50,7,48,7,2,1
구재이,43551,6,9,6,9,0,0
구정슈퍼앞,35498,6,95,6,95,0,3
구정슈퍼앞,35587,97,24,95,24,2,3
구정정미소,90284,0,17,0,17,0,0
구정정미소,90306,7,2,7,2,0,0
구중학교앞,44119,4,6,4,6,0,0
구중학교앞,44148,6,0,6,0,0,0
구하1리입구,43259,2,66,2,66,0,2
구하1리입구,43562,180,2,166,2,14,5
구하2리마을회관,43254,97,0,94,0,3,3
구하2리마을회관,43256,91,0,90,0,1,2
구하2리마을회관,43373,0,71,0,71,0,2
구하2리마을회관,43559,0,81,0,81,0,2
국궁장앞,70151,22,192,22,192,0,6
국립생물자원관,89111,223,611,223,611,0,26
국립생물자원관입구,42741,501,536,501,536,0,33
국립인천공항검역소,35430,15,165,15,165,0,5
국립인천공항검역소,35431,17,98,17,98,0,3
국민건강보험 인천부평지사,40620,1126,3771,1119,3771,7,157
국민건강보험 인천부평지사,40621,3110,1597,3087,1597,23,151
국민건강보험남부지사,37274,12331,12302,12321,12302,10,794
국민은행,38148,2175,5537,2175,5537,0,248
국민은행,38149,5655,2279,5655,2279,0,255
국민은행연수중앙지점,38129,4836,3465,4836,3465,0,267
국민은행연수중앙지점,38571,1741,3218,1741,3218,0,159
국제금융단지,89292,8426,6332,8426,6332,0,476
국제금융단지,89293,2703,6891,2703,6891,0,309
국제성모병원,89030,345,1640,342,1640,3,64
국제성모병원,89031,2512,1007,2512,1007,0,113
국제성모병원(종점),89369,3,104,3,104,0,3
국제업무단지(공항청사),35026,13995,3616,13995,3616,0,568
국제업무지구역,38528,2132,3876,2132,3876,0,193
국제업무지구역5번출구,38619,3093,2385,3090,2385,3,176
국제이노베이션,37573,1,1846,1,1846,0,59
국제콘크리트,90050,44,32,43,32,1,2
국제콘크리트,90051,15,116,14,116,1,4
국제학교,38457,2791,1170,2791,1170,0,127
국제학교,38462,1529,2815,1529,2815,0,140
국촌,43251,64,3,52,3,12,2
국촌,43371,1,57,1,57,0,1
국화리야영장앞,43353,52,2,50,2,2,1
국화리야영장앞,43843,1,54,1,54,0,1
국화맨션,43359,1,8,1,8,0,0
국화맨션,43566,7,10,7,10,0,0
국회연수원입구,43920,0,27,0,27,0,0
군인아파트,43046,158,30,157,30,1,6
군인아파트,43047,47,134,47,134,0,5
굴다리,37142,8588,101,8588,101,0,280
굴다리오거리,40231,15392,7987,15380,7987,12,754
굴다리오거리,40232,14711,21891,14687,21891,24,1180
굴다리입구,37152,8032,3691,7998,3691,34,378
굴포천,40506,2420,2797,2420,2797,0,168
굴포천,40509,2988,3856,2987,3856,1,220
굴포천역(롯데마트),40814,41194,23461,41191,23461,3,2085
굴포천역(롯데마트),40815,17747,21407,17747,21407,0,1263
굴포천역(부평농협),40507,6309,8768,6308,8768,1,486
굴포천역(부평농협),40508,9775,6025,9769,6025,6,509
굴포천역(신복사거리),40485,4325,20031,4325,20031,0,785
굴포천역(신복사거리),40498,28794,7184,28794,7184,0,1160
굴포천역(욱일아파트),40519,4354,13656,4351,13656,3,580
굴포천역(욱일아파트),40522,8953,2835,8938,2835,15,380
궁골,43346,0,11,0,11,0,0
궁골,43572,3,0,3,0,0,0
궁현사거리,37575,3,812,3,812,0,26
궁현사거리,37576,311,0,311,0,0,10
귀뚜라미보일러,42003,4,151,4,151,0,5
귀뚜라미보일러,42004,156,0,156,0,0,5
귤현감리교회,41385,1986,5688,1986,5688,0,247
귤현감리교회,41386,4330,3095,4330,3095,0,239
귤현동마을입구,41326,419,131,416,131,3,17
귤현동마을입구,41328,98,558,98,558,0,21
귤현아이파크정문,41572,1899,398,1899,398,0,74
귤현역,41331,9314,3979,9314,3979,0,428
귤현역,41332,1341,867,1341,867,0,71
귤현차량기지(센트레빌3단지),41443,2416,798,2416,798,0,103
귤현차량기지(센트레빌3단지),41444,1029,3283,1029,3283,0,139
귤현차량기지(안골공원),41618,1746,2139,1746,2139,0,125
귤현차량기지(안골공원),41619,130,560,130,560,0,22
귤현차량사업소,41670,20,171,20,171,0,6
귤현현대아이파크,41620,564,1941,564,1941,0,80
그린나래지하차도,35648,14,618,14,618,0,20
그린나래지하차도,35649,2393,1054,2393,1054,0,111
그린빌라,42222,1985,1312,1959,1312,26,106
그린빌라,42602,1263,2740,1259,2740,4,129
그린힐아파트.e편한세상아파트,40194,325,1515,322,1515,3,59
극동.금호아파트,39272,4518,6758,4485,6758,33,363
극동.금호아파트,39278,5603,5158,5597,5158,6,347
극지연구소,39918,2017,2666,2017,2666,0,151
극지연구소,39919,3781,2394,3781,2394,0,199
근대문화거리입구,35369,2121,4177,2120,4177,1,203
근대문화거리입구,35370,2904,1927,2903,1927,1,155
근로복지공단인천병원,40145,10332,12858,10321,12858,11,748
근로복지공단인천병원,40155,20523,10229,20515,10229,8,992
글로벌캠퍼스푸르지오,39841,2055,7990,2052,7990,3,324
글로벌파크,39975,772,795,772,795,0,50
글로벌파크,39976,179,1781,179,1781,0,63
글로벌파크베르디움,39840,6802,1523,6799,1523,3,268
금강다이아몬드,39007,420,1558,420,1558,0,63
금강다이아몬드,39008,741,335,741,335,0,34
금강마을,55066,1957,2509,1953,2509,4,144
금강마을,55068,5085,818,5085,818,0,190
금강요양병원,37291,7848,5832,7848,5832,0,441
금강종합상가,42858,1093,17,1093,17,0,35
금강찜질방,44113,14,2,13,2,1,0
금강찜질방,44149,7,60,7,60,0,2
금강찜질방,44150,7,26,7,26,0,1
금강찜질방,44151,7,0,6,0,1,0
금강탱크터미널,42758,949,2067,949,2067,0,97
금강펜테리움더시글로,89392,11164,5027,11164,5027,0,522
금강펜테리움더시글로,89459,3425,4590,3425,4590,0,258
금곡교차로,89370,17,31,17,31,0,1
금곡동,42471,18,135,18,135,0,4
금곡동,42587,437,78,436,78,1,16
금곡종점,89319,100,63,89,63,11,5
금란마트,89056,91,840,91,840,0,30
금란마트,89061,11,249,9,249,2,8
금마초등학교,40833,6418,3891,6319,3891,99,332
금산경로당,35564,5,588,4,588,1,19
금산경로당,35565,16,3,16,3,0,0
금성목재,42812,2,186,2,186,0,6
금운교,43298,0,35,0,35,0,1
금운교,43858,4,42,4,42,0,1
금월리종점,43777,196,87,195,87,1,9
금정골입구,90301,5,6,5,6,0,0
금정부락,90300,3,3,3,3,0,0
금호2차아파트,37031,7513,1177,7499,1177,14,280
금호2차아파트,37033,1911,5081,1895,5081,16,225
금호베스트빌1단지.영종도서관,35112,1494,2222,1493,2222,1,119
금호베스트빌1단지.영종도서관,35113,4297,1611,4297,1611,0,190
금호아파트,37061,213,501,213,501,0,23
금호아파트,38302,606,969,606,969,0,50
금호아파트,38349,11071,3492,11052,3492,19,469
금호아파트,40441,3544,1507,3544,1507,0,162
금호아파트,40795,22408,19714,22404,19714,4,1358
금호아파트,40845,7670,8887,7670,8887,0,534
금호어울림,35313,3361,1245,3361,1245,0,148
금호어울림,35384,1118,2930,1118,2930,0,130
금호어울림,37048,1186,2409,1169,2409,17,115
금호어울림2차,35597,2,0,2,0,0,0
금호어울림2차,35598,0,7,0,7,0,0
금호어울림아파트,42137,3930,2306,3930,2306,0,201
금호어울림아파트,42139,2402,2772,2400,2772,2,166
금호어울림아파트,42592,135,1524,135,1524,0,53
금호어울림아파트,42593,1784,688,1784,688,0,79
금호이수마운트밸리,40316,412,1149,412,1149,0,50
금호종합열처리,42801,731,115,731,115,0,27
금호타운,37024,14730,3367,14723,3367,7,583
금호타운,37026,4719,16013,4717,16013,2,668
금홍염전,35543,757,222,757,222,0,31
금홍염전,35544,437,3411,437,3411,0,124
기계공고,37294,4771,3034,4771,3034,0,251
기계철제단지,36129,8,226,8,226,0,7
기계철제단지,36149,129,83,129,83,0,6
기신정기,39567,884,1580,884,1580,0,79
기업은행(구월동지점),39178,279,571,279,571,0,27
기업은행앞,70152,150,41,150,41,0,6
기점(미정차)_517 519,37677,1264,0,1264,0,0,40
긴마루교회입구,35686,88,28,87,28,1,3
긴마루교회입구,35692,6,46,6,46,0,1
길병원,39250,79434,79300,79415,79300,19,5120
길병원,39262,14185,11328,14179,11328,6,823
길병원,39264,6754,9276,6743,9276,11,517
길병원,39590,73529,68716,73497,68716,32,4588
길병원사거리,39212,21401,19991,21372,19991,29,1335
길병원사거리,39216,20010,25260,19975,25260,35,1460
길상교회,43148,35,3,35,3,0,1
길상교회,43701,5,30,5,30,0,1
길상군립어린이집,43959,57,24,57,24,0,2
길상군립어린이집,43960,26,108,26,108,0,4
길상낚시터,43149,16,14,16,14,0,0
길상낚시터,43883,6,7,6,7,0,0
길상면주민복합센터,90409,90,208,90,208,0,9
길상면주민복합센터,90410,231,264,228,264,3,15
길상보건지소,43021,319,418,319,418,0,23
길상보건지소,43069,255,349,254,349,1,19
길정저수지,90054,3,4,3,4,0,0
길정저수지,90055,6,4,6,4,0,0
길직1리,43270,96,132,95,132,1,7
길직리,43031,225,171,224,171,1,12
길직리입구,43304,11,89,11,89,0,3
길직리입구,43313,45,7,45,7,0,1
길훈4차아파트,80040,20,328,20,328,0,11
길훈4차아파트,80041,334,3,334,3,0,10
길훈아파트,42494,9871,10398,9865,10398,6,653
김미현골프장,39749,1110,750,1110,750,0,60
김미현골프장,39751,660,1827,660,1827,0,80
김소골,35675,20,33,20,33,0,1
김소골,35703,58,36,57,36,1,3
김지곡,43455,0,105,0,105,0,3
김지곡,43831,103,4,101,4,2,3
김포공항국내선,25029,1382,2769,1381,2769,1,133
김포공항국내선,25091,589,94,588,94,1,22
김포공항국제선,25006,754,4624,754,4624,0,173
김포공항국제선,25164,81,132,80,132,1,6
김포대학입구,80257,504,64,504,64,0,18
김포대학입구,80258,75,478,75,478,0,17
김포초교,80028,145,486,145,486,0,20
김포초교,80030,534,105,534,105,0,20
김포한강신협,80032,1023,1384,1023,1384,0,77
김포한강신협,80035,1159,1192,1159,1192,0,75
까치공원.작전도서관,41149,15648,11846,15641,11846,7,886
까치말사거리,41563,9783,3897,9783,3897,0,441
까치말사거리,41564,3960,7452,3960,7452,0,368
꿈동산.사랑마을,55022,1488,2193,1488,2193,0,118
꿈동산.사랑마을,55024,1535,108,1534,108,1,53
꿈에그린아파트,92023,3408,4482,3408,4482,0,254
나누리병원,40398,27838,21167,27838,21167,0,1580
나누리병원,40784,24580,20737,24580,20737,0,1461
나래병원,38142,2937,2049,2937,2049,0,160
나룻개,35593,43,256,43,256,0,9
나룻개,35594,234,39,232,39,2,8
나룻개입구,35385,26,355,26,355,0,12
나룻개입구,35386,314,27,313,27,1,11
나무깨,90183,4,1,4,1,0,0
나무깨,90184,7,3,7,3,0,0
나무다리,90340,1,10,1,10,0,0
나무다리,90344,8,0,8,0,0,0
나사렛국제병원앞,38068,49067,15855,48994,15855,73,2094
나은병원,42056,7273,2363,7241,2363,32,310
낚시터매점,43356,17,37,17,37,0,1
낚시터매점,43840,33,0,32,0,1,1
낚시터입구,42802,100,850,100,850,0,30
난곳정미소,90286,31,69,31,69,0,3
난정1리마을회관,90285,17,18,17,18,0,1
난정1리마을회관,90287,15,2,15,2,0,0
난정교회앞,90288,1,3,1,3,0,0
난정보건진료소앞,90289,1,4,1,4,0,0
난정초등학교입구,90305,22,11,22,11,0,1
남광로얄아파트,37257,19812,28509,19789,28509,23,1558
남광하우스토리,42841,3294,910,3291,910,3,135
남광하우스토리,42920,4855,1748,4851,1748,4,213
남광하우스토리,42921,2238,4617,2238,4617,0,221
남동I.C(문학동입구),39168,217,3900,217,3900,0,132
남동경기장,92055,385,59,385,59,0,14
남동경찰서·남촌농산물도매시장,39147,3768,1862,3765,1862,3,181
남동경찰서·남촌농산물도매시장,39148,2407,1765,2391,1765,16,134
남동고등학교,92035,131,307,131,307,0,14
남동고등학교,92036,22,87,22,87,0,3
남동공단2호공원,39075,770,5576,770,5576,0,204
남동공단근린공원앞,39073,5308,1045,5308,1045,0,204
남동공단우체국,39076,1927,6211,1927,6211,0,262
남동구청,39263,10933,8350,10931,8350,2,622
남동구청,39279,10707,10434,10705,10434,2,681
남동구청역,39318,12421,8141,12417,8141,4,663
남동구청역,39324,12842,14513,12831,14513,11,882
남동구청후문(남동등기소),39287,5177,11150,5172,11150,5,526
남동구청후문(남동등기소),39288,5156,2939,5153,2939,3,261
남동국가산업단지 입구,39853,606,40,597,40,9,20
남동국가산업단지(기신정기),39568,1703,1288,1703,1288,0,96
남동대교,38090,2568,7642,2568,7642,0,329
남동대교(스퀘어원),39063,6024,3238,5953,3238,71,298
남동빌라,39330,5366,1908,5365,1908,1,234
남동세무서,39887,20954,11395,20949,11395,5,1043
남동세무서,39888,12889,22766,12886,22766,3,1150
남동소래아트홀,39743,583,97,583,97,0,21
남동소래아트홀,39744,258,83,258,83,0,11
남동소래아트홀,39748,181,209,181,209,0,12
남동소래아트홀,39792,101,499,101,499,0,19
남동소방서,39252,1233,2660,1233,2660,0,125
남동소방서,39587,10896,6648,10838,6648,58,565
남동시범공단앞,39100,3531,5307,3531,5307,0,285
남동시범공단앞,39102,6416,2901,6416,2901,0,300
남동아시아드럭비경기장,39214,349,856,349,856,0,38
남동아시아드럭비경기장,39215,279,688,279,688,0,31
남동인더스파크역,39074,13421,2431,13421,2431,0,511
남동인더스파크역1번출구,92045,94,0,94,0,0,3
남동인더스파크역1번출구,92050,0,140,0,140,0,4
남동정수장,39372,254,682,254,682,0,30
남동중학교,39220,11217,7291,11212,7291,5,597
남동중학교,39224,6962,5336,6957,5336,5,396
남동체육관,39930,926,849,926,849,0,57
남동체육관,39947,686,1597,686,1597,0,73
남동체육관(체조경기장),39682,1682,2629,1682,2629,0,139
남동체육관(체조경기장),39862,1096,761,1096,761,0,59
남동초등학교,39254,17243,26803,17240,26803,3,1420
남동초등학교,39255,31239,14621,31234,14621,5,1479
남동초등학교,39265,4622,469,4622,469,0,164
남동화원,39300,6414,6316,6414,6316,0,410
남디4거리,35271,500,956,499,956,1,46
남디4거리,35280,592,593,591,593,1,38
남부고가교,40921,13,254,13,254,0,8
남산리,43324,5,0,5,0,0,0
남산리,43628,25,13,25,13,0,1
남산유스호스텔,43982,16,0,16,0,0,0
남산유스호스텔,43985,25,28,20,28,5,1
남산포입구,90030,7,24,7,24,0,1
남산포입구,90031,51,0,45,0,6,1
남성네고개,35426,50,171,50,171,0,7
남성네고개,35427,168,30,168,30,0,6
남씨농원앞,41495,16,63,16,63,0,2
남씨농원앞,41511,21,0,21,0,0,0
남양목재,42814,0,171,0,171,0,5
남인천농협백운지점,37174,228,959,228,959,0,38
남인천새마을금고중앙지점,37300,13429,15057,13396,15057,33,918
남인천여자중학교,39190,19062,6199,19034,6199,28,814
남인천여자중학교,39191,8000,18678,7993,18678,7,860
남중학교,37331,5653,552,5653,552,0,200
남중학교,37336,8287,23885,8287,23885,0,1037
남청라TG,89379,162,0,162,0,0,5
남청라TG,89380,1,141,1,141,0,4
남촌농산물도매시장,92031,5376,78,5376,78,0,175
남촌농산물도매시장,92032,25,3601,25,3601,0,116
남촌농산물도매시장채소동앞,92033,74,1680,74,1680,0,56
남촌농산물도매시장채소동앞,92034,364,578,364,578,0,30
남촌동다목적센터,39908,60,1352,58,1352,2,45
남촌동다목적체육센터,39907,242,260,240,260,2,16
남촌동입구,39166,3953,9403,3947,9403,6,430
남촌입구,39156,212,633,212,633,0,27
남촌입구,39157,571,1605,569,1605,2,70
남촌풍림2차아파트,39171,5821,11362,5817,11362,4,554
남촌풍림3차아파트,39165,4884,4617,4881,4617,3,306
남촌풍림3차아파트,39167,4604,5232,4600,5232,4,317
남촌풍림아파트,39172,12033,3512,12027,3512,6,501
남항유어선부두,35078,6018,1159,5957,1159,61,231
남항유어선부두,35079,157,5052,146,5052,11,168
납섬입구,90185,8,6,8,6,0,0
납섬입구,90186,6,14,6,14,0,0
내2리마을회관앞,44138,6,3,4,3,2,0
내2리마을회관앞,44152,61,14,61,14,0,2
내3리다목적회관앞,44121,0,3,0,3,0,0
내3리마을회관,44154,17,0,16,0,1,0
내3리마을회관,44155,0,16,0,16,0,0
내3리마을회관,44156,25,2,25,2,0,0
내4리마을회관,44104,33,60,30,60,3,3
내4리마을회관,44157,48,9,23,9,25,1
내5리마을회관,44128,19,0,18,0,1,0
내5리마을회관,44158,1,0,1,0,0,0
내7리마을회관,44118,0,12,0,12,0,0
내7리마을회관,44159,13,6,9,6,4,0
내가면사무소(맞은편),43906,87,48,86,48,1,4
내가면사무소(사무소),43907,35,138,35,138,0,5
내가시장,43392,194,255,192,255,2,14
내가시장,43484,349,126,328,126,21,15
내가초등학교,43368,108,9,103,9,5,3
내가초등학교,43554,22,149,22,149,0,5
내건너,90167,37,28,36,28,1,2
내건너,90168,19,19,19,19,0,1
내동교회,44114,8,11,8,11,0,0
내동교회,44206,2,7,2,7,0,0
내동삼거리,44111,5,34,3,34,2,1
내리고개넘어,44102,1,1,1,1,0,0
내리교회,43395,17,12,17,12,0,0
내리교회,43543,40,44,36,44,4,2
내리쉼터,43968,0,4,0,4,0,0
내리쉼터,43972,6,0,6,0,0,0
내리어촌계사무실,44135,0,19,0,19,0,0
내리어촌계사무실,44204,2,0,2,0,0,0
내리주유소.한국화장품삼거리,57016,1503,1716,1503,1716,0,103
내리주유소.한국화장품삼거리,57018,2251,2150,2251,2150,0,141
내촌,43343,89,97,88,97,1,6
내촌,43581,61,29,61,29,0,2
내촌입구,90394,7,80,7,80,0,2
내촌입구,90395,44,43,44,43,0,2
너출(드무리입구),44086,0,2,0,2,0,0
너출(드무리입구),44161,6,0,2,0,4,0
넘말,43140,17,2,17,2,0,0
넘말,43438,1,10,1,10,0,0
넙디,35574,2072,8271,2072,8271,0,333
넙디,35575,9861,1718,9861,1718,0,373
넙디마을입구,35389,146,189,146,189,0,10
노가리해변,44105,0,1,0,1,0,0
노랑새고개,43273,130,27,127,27,3,5
노랑새고개,43570,35,173,34,173,1,6
노인복지관,92072,1562,1536,1561,1536,1,99
노인복지관,92073,1074,4161,1073,4161,1,168
노인복지회관,37599,165,741,165,741,0,29
노인인력개발센터,40134,915,209,915,209,0,36
노인인력개발센터,40745,113,1124,113,1124,0,39
녹청자박물관,42668,2682,507,2682,507,0,102
녹청자박물관,42669,244,2057,244,2057,0,74
논고개길,39687,2085,2370,2077,2370,8,143
논고개길,39819,1893,2056,1893,2056,0,127
논고개길사거리,39870,261,5,257,5,4,8
논골,35318,8,3,8,3,0,0
논골,35394,22,13,22,13,0,1
논골,44098,0,3,0,3,0,0
논골,44163,2,11,2,11,0,0
논골경로당 입구,35770,4,7,4,7,0,0
논골경로당 입구,35771,2,2,2,2,0,0
논현10단지별빛마을웰카운티A정문,39121,5702,2796,5699,2796,3,274
논현10단지별빛마을웰카운티A후문,39599,926,1573,920,1573,6,80
논현12단지산뒤마을,39609,5133,12890,5123,12890,10,581
논현13단지푸르네마을,39611,3653,7210,3647,7210,6,350
논현13단지푸르네마을,39617,4860,2494,4860,2494,0,237
논현13단지푸르네마을,39618,1937,2744,1937,2744,0,151
논현14단지등대마을,39610,9811,1488,9761,1488,50,364
논현14단지등대마을휴먼시아아파트,39612,9817,3828,9776,3828,41,440
논현1동행정복지센터,39598,1413,782,1406,782,7,70
논현2단지범마을,39625,2674,11294,2673,11294,1,450
논현2동행정복지센터,39571,1442,171,1442,171,0,52
논현2동행정복지센터,39572,193,1050,193,1050,0,40
논현2동행정복지센터,39636,1349,3136,1349,3136,0,144
논현2동행정복지센터,39697,2899,1413,2899,1413,0,139
논현3단지하늘마을301동,39631,119,3477,118,3477,1,116
논현3단지하늘마을302동,39624,17848,5600,17820,5600,28,756
논현3단지하늘마을305동,39626,2105,5208,2105,5208,0,235
논현3단지하늘마을305동,39627,3895,2385,3895,2385,0,202
논현5단지달맞이마을,39079,9528,3517,9522,3517,6,420
논현6단지어진마을한화꿈에그린A정문,39078,4032,7230,4032,7230,0,363
논현8단지동산마을,39104,5127,2144,5127,2144,0,234
논현8단지동산마을,39569,511,1105,511,1105,0,52
논현8단지동산마을,39570,820,551,820,551,0,44
논현9단지냇마을신영지웰A,39101,2276,4279,2276,4279,0,211
논현9단지냇마을신영지웰A,39602,382,148,381,148,1,17
논현9단지냇마을신영지웰A,39603,37,659,37,659,0,22
논현9단지냇마을신영지웰A정문,39600,2303,1039,2301,1039,2,107
논현고잔동행정복지센터,39707,8164,13352,8155,13352,9,694
논현단풍마을트리플에듀,39582,3682,5718,3682,5718,0,303
논현단풍마을트리플에듀,39616,437,205,437,205,0,20
논현동힐스테이트,39708,20806,9717,20787,9717,19,984
논현사거리,39504,5231,4578,5222,4578,9,316
논현사거리,39505,4094,4679,4089,4679,5,283
논현센트럴뷰·에코메트로5단지,39693,699,978,699,978,0,54
논현신일해피트리아파트,39088,2317,7476,2317,7476,0,315
논현신일해피트리아파트,39089,7166,2905,7156,2905,10,324
논현역,32007,143,3031,143,3031,0,102
논현역,32008,3787,50,3787,50,0,123
논현유승한내들,39839,1446,3070,1446,3070,0,145
논현유승한내들,39923,3267,1092,3265,1092,2,140
논현주공1단지,39112,14141,6970,14139,6970,2,681
논현주공2단지,39106,11902,12857,11898,12857,4,798
논현주공아파트(인천금융고),39096,13510,11051,13510,11051,0,792
논현주공아파트(인천금융고),39098,16317,14449,16317,14449,0,992
논현중앙공원·남동논현도서관,39604,475,1868,472,1868,3,75
논현중학교,39573,1167,179,1167,179,0,43
논현중학교,39574,48,705,48,705,0,24
논현초등학교,39601,703,2104,703,2104,0,90
논현파크포레,39649,6149,3738,6143,3738,6,318
논현파크포레,39722,1457,4356,1451,4356,6,187
논현포대근린공원,92056,63,80,63,80,0,4
논현푸르지오.유호엔시티,39822,2042,100,2041,100,1,69
논현화훼단지,39830,163,1178,161,1178,2,43
논현화훼단지,39831,222,848,222,848,0,34
농기계은행앞,90036,0,31,0,31,0,1
농기계은행앞,90037,31,0,31,0,0,1
농도원,43178,8,55,7,55,1,2
농도원,43355,141,41,141,41,0,5
농막골,90189,16,2,16,2,0,0
농막골,90190,3,10,1,10,2,0
농산물시장,40688,3698,1009,3698,1009,0,151
농어바위캠핑장,44140,0,1,0,1,0,0
농어바위캠핑장,44164,19,21,19,21,0,1
농어촌공사앞,43268,147,13,146,13,1,5
농어촌공사앞,43489,24,100,17,100,7,4
농업기술센터,43357,253,141,251,141,2,12
농업기술센터,43573,62,252,62,252,0,10
농장주유소,39472,348,1066,348,1066,0,45
농장주유소,39508,224,680,224,680,0,29
농협로타리,40244,1638,2882,1638,2882,0,145
농협로타리,40248,2216,1172,2216,1172,0,109
농협로타리,40251,1458,2522,1458,2522,0,128
농협로타리,40751,4559,2848,4544,2848,15,238
농협하나로마트,44117,4,1,4,1,0,0
농협하나로마트,44165,0,3,0,3,0,0
높은마을입구,35685,39,36,38,36,1,2
높은마을입구,35693,51,83,50,83,1,4
누촌,43238,62,179,62,179,0,7
누촌,43360,143,33,143,33,0,5
뉴그린아트빌,40875,1232,883,1232,883,0,68
뉴그린아트빌,40876,247,1566,247,1566,0,58
뉴서울1차아파트,40275,13238,7198,13107,7198,131,659
뉴서울3차아파트,41026,2038,4165,2038,4165,0,200
뉴서울3차아파트,41029,8487,1155,8481,1155,6,311
뉴서울3차아파트,41032,1157,5279,1136,5279,21,207
뉴서울6차아파트,41632,1256,339,1254,339,2,51
뉴서울6차아파트,41635,413,1246,413,1246,0,53
뉴서울아파트,38303,1559,1479,1550,1479,9,98
뉴서울아파트,39234,8443,156,8443,156,0,277
뉴서울아파트,39235,190,4447,190,4447,0,149
뉴서울아파트,40505,2196,1269,2196,1269,0,111
뉴서울아파트,40514,640,740,638,740,2,44
뉴서울아파트,40526,1904,4375,1902,4375,2,202
뉴서울아파트,41153,6171,7053,6171,7053,0,426
뉴서울아파트,89071,9771,21057,9749,21057,22,994
느티나무,43182,26,66,26,66,0,2
느티나무,43232,107,17,105,17,2,4
늘목,35414,176,631,175,631,1,26
늘목,35415,504,82,504,82,0,18
늘목마을입구,35529,18,43,18,43,0,1
늘목마을입구,35725,32,27,32,27,0,1
늘목마을입구삼거리,35889,0,7,0,7,0,0
늘푸른벽산.서강2차,70021,24,2343,24,2343,0,76
능곡마을회관,43553,71,12,65,12,6,2
능곡마을회관,43649,11,59,11,59,0,2
능미,43921,60,4,59,4,1,2
능미,43922,5,58,5,58,0,2
능안,43276,60,59,57,59,3,3
능안,43571,25,64,25,64,0,2
능촌삼거리,90370,0,7,0,7,0,0
능촌입구,43560,25,1,24,1,1,0
능촌입구,43854,0,61,0,61,0,1
능허대공원,38567,617,1034,617,1034,0,53
능허대공원,38777,224,130,189,130,35,11
다남동소촌마을입구,41329,470,6,470,6,0,15
다남동소촌마을입구,41330,11,612,11,612,0,20
다남동역골입구,41333,2,255,2,255,0,8
다남동역골입구,41334,231,16,231,16,0,7
다남성결교회,41664,60,94,60,94,0,4
다남성결교회,41665,9,192,9,192,0,6
다남식당,41477,2039,18279,2038,18279,1,655
다남식당,41478,764,3493,764,3493,0,137
다리목,43717,10,17,10,17,0,0
다리목,43845,9,12,9,12,0,0
다사랑마을입구,35887,51,19,50,19,1,2
다사랑마을입구,35888,16,37,16,37,0,1
다우리농장,44083,3,0,1,0,2,0
다우리농장,44166,0,3,0,3,0,0
다운,43605,89,101,85,101,4,6
다운,43822,77,67,76,67,1,4
다운1리,43582,13,116,13,116,0,4
다운1리,43821,68,13,68,13,0,2
다운마을,43398,1,93,1,93,0,3
다운마을,43824,90,2,89,2,1,2
다임메가타운,40870,73,639,73,639,0,22
단봉초등학교,42380,4089,852,4086,852,3,159
단봉초등학교,42382,1026,3436,1021,3436,5,143
달빛축제공원,38620,167,110,167,110,0,8
달빛축제공원,38621,87,781,87,781,0,28
달빛축제공원대공연장,38733,299,720,299,720,0,32
달빛축제공원대공연장,38734,1042,428,1042,428,0,47
담방로사거리,39275,12260,4297,12258,4297,2,534
담방아파트,39226,652,67,652,67,0,23
당곡고개,80048,158,829,158,829,0,31
당곡고개,80049,718,79,718,79,0,25
당미마을,41552,4567,6531,4567,6531,0,358
당미마을,41553,4494,3598,4494,3598,0,261
당산리,43450,7,145,7,145,0,4
당산리,43700,177,8,171,8,6,5
당산리검문소,43699,146,13,143,13,3,5
당산리검문소,43752,9,138,9,138,0,4
당산종점,43669,2,41,2,41,0,1
당산종점,43725,43,3,39,3,4,1
당산초등학교,41418,5195,2775,5195,2775,0,257
당산초등학교,41419,1541,2445,1541,2445,0,128
당산초등학교아래사거리,41644,3,124,3,124,0,4
당산초등학교아래사거리,41645,397,192,397,192,0,19
당하대주파크빌,42392,2426,1975,2424,1975,2,141
당하동탑스빌아파트,42639,4162,3327,4162,3327,0,241
당하동행정복지센터,42886,11727,6261,11727,6261,0,580
당하메디칼,42402,1767,2284,1762,2284,5,130
당하초등학교,42396,1414,979,1412,979,2,77
당하초등학교,42399,1265,1391,1264,1391,1,85
당하탑스빌아파트,42393,2757,2743,2757,2743,0,177
당하푸르지오,42403,1168,833,1167,833,1,64
당하푸르지오,42502,809,4600,809,4600,0,174
당하풍림아파트,42405,1768,11576,1768,11576,0,430
대경화성,39789,1124,874,1124,874,0,64
대경화성,39790,1061,1646,1061,1646,0,87
대곶사거리,80008,1606,5830,1600,5830,6,239
대곶사거리,80009,6944,1657,6922,1657,22,277
대기이에스티,39013,147,359,147,359,0,16
대덕강업앞,42759,19,580,19,580,0,19
대동1차후문(종점),40553,417,701,417,701,0,36
대동도어(주),39983,486,13,486,13,0,16
대동도어(주),39984,7,729,7,729,0,23
대동아파트,37042,8684,2476,8684,2476,0,360
대동아파트,37504,4676,7858,4675,7858,1,404
대동아파트,38128,6387,11710,6379,11710,8,583
대동아파트,38345,5105,5450,5096,5450,9,340
대동아파트,39256,291,4822,291,4822,0,164
대동아파트,39473,3615,202,3588,202,27,123
대동아파트,39474,98,7230,88,7230,10,236
대동아파트,40491,625,237,625,237,0,27
대동아파트,40569,8114,3390,8112,3390,2,371
대동아파트,41172,2539,667,2539,667,0,103
대동아파트,42304,2258,4238,2247,4238,11,209
대동아파트,42306,3232,1806,3226,1806,6,162
대동아파트정문앞,40277,1175,985,1172,985,3,69
대동아파트후문,41137,2260,4450,2258,4450,2,216
대동월드,38116,4971,2712,4971,2712,0,247
대동특수철강,39049,103,1015,103,1015,0,36
대룡2리마을회관앞,90026,2,41,2,41,0,1
대룡2리마을회관앞,90027,45,2,44,2,1,1
대룡시장,90020,415,1408,411,1408,4,58
대룡시장,90021,1499,374,1469,374,30,60
대륭맨숀,40242,9816,5994,9816,5994,0,510
대륭맨숀,40247,10425,10948,10425,10948,0,689
대림3차아파트301동앞,38681,436,23,436,23,0,14
대림3차아파트301동앞,38684,30,743,30,743,0,24
대림아파트,37053,10831,4444,10831,4444,0,492
대림아파트,37054,3302,7923,3302,7923,0,362
대림아파트,38257,6133,1459,6133,1459,0,244
대림아파트,40382,3470,11446,3459,11446,11,481
대림아파트,42609,1828,1355,1817,1355,11,102
대림아파트,42610,157,2001,155,2001,2,69
대림아파트후문,40397,2105,1639,2105,1639,0,120
대명아파트,37537,2491,6206,2491,6206,0,280
대명초교,80002,1909,202,1905,202,4,68
대명초교,80003,357,1620,355,1620,2,63
대문리고개입구,43546,472,322,470,322,2,25
대문목재,89206,129,47,129,47,0,5
대문목재,89207,178,19,178,19,0,6
대문촌마을,90058,22,7,21,7,1,0
대문촌마을,90059,11,4,11,4,0,0
대박주유소,36091,2329,2624,2329,2624,0,159
대부고교차로,18388,1,19,1,19,0,0
대부관광호텔,62040,248,64,248,64,0,10
대부도서관,18389,2,18,2,18,0,0
대부도서관,18391,10,24,10,24,0,1
대부동행정복지센터,62011,289,1247,289,1247,0,49
대부동행정복지센터,62012,1366,249,1366,249,0,52
대부중고등학교,62027,298,40,298,40,0,10
대부중고등학교,62028,26,287,26,287,0,10
대부파출소앞,62036,4,85,4,85,0,2
대부파출소앞,62042,113,5,113,5,0,3
대사마을,43947,9,194,9,194,0,6
대사마을,43948,182,13,179,13,3,6
대산-기점,90259,3242,3104,3190,3104,52,204
대상스틸,89007,60,567,59,567,1,20
대성베르힐아파트(가정성당),89240,1445,2961,1445,2961,0,142
대성베르힐아파트(가정성당),89241,6007,2329,6007,2329,0,268
대성유니드아파트,40674,986,4552,986,4552,0,178
대성유니드아파트,40675,2428,406,2428,406,0,91
대신아파트,41406,5665,1726,5665,1726,0,238
대신철강,42859,11,1162,11,1162,0,37
대야초교.ABC학습타운입구,70017,335,1701,335,1701,0,65
대야초교.ABC학습타운입구,70020,1963,622,1963,622,0,83
대양자동차학원,35073,14,2213,8,2213,6,71
대우삼환아파트,38078,6256,4196,6256,4196,0,337
대우삼환아파트,38591,1352,3308,1351,3308,1,150
대우실업,41485,21,34,21,34,0,1
대우실업,41505,22,1,22,1,0,0
대우아파트,38206,4482,3898,4481,3898,1,270
대우아파트,38208,3770,3260,3769,3260,1,226
대우아파트,40321,143,398,143,398,0,17
대우아파트,40340,797,540,797,540,0,43
대우일렉트로닉스,37462,56,1037,56,1037,0,35
대우일렉트로닉스,37463,46,397,46,397,0,14
대우자동차운전학원,42262,473,289,473,289,0,24
대우자동차운전학원,42263,202,408,202,408,0,19
대우재아파트,39702,12,399,9,399,3,13
대우재아파트,39703,513,407,510,407,3,29
대우푸르지오,42407,29772,4158,29771,4158,1,1094
대우푸르지오,42842,1036,3674,1030,3674,6,151
대우푸르지오복합상가,39605,2776,1740,2756,1740,20,145
대우하나아파트,89073,18342,10861,18321,10861,21,942
대우하나아파트,89074,9055,12747,9044,12747,11,703
대웅실업앞,92003,35,317,35,317,0,11
대원레스피아1단지아파트,42643,8892,58,8892,58,0,288
대원정밀,39475,418,804,418,804,0,39
대월초등학교,90094,0,4,0,4,0,0
대월초등학교,90095,10,0,10,0,0,0
대은교회,42143,5031,8903,5016,8903,15,449
대인고등학교,42344,2288,3178,2286,3178,2,176
대인고등학교,42345,4016,1858,3997,1858,19,189
대인고등학교,89490,268,994,268,994,0,40
대일엠앤쿡,39059,734,1786,734,1786,0,81
대장간마을,43703,339,152,323,152,16,15
대정,90117,3,74,3,74,0,2
대정,90118,62,1,61,1,1,2
대주아파트,42469,1924,11528,1924,11528,0,433
대주파크빌,42466,6129,1143,6129,1143,0,234
대진아파트,40415,2598,2495,2598,2495,0,164
대촌,43393,52,68,50,68,2,3
대촌,43545,29,21,29,21,0,1
대촌마을,41663,24,5,24,5,0,0
대토단지앞,39813,953,25,953,25,0,31
대한솔루션알앤디센터,39557,20,405,20,405,0,13
대한제당,35169,1106,43,1105,43,1,37
대한제당,35220,23,1401,23,1401,0,45
대현목재,89205,160,26,160,26,0,6
대화초등학교,37397,6474,2472,6474,2472,0,288
대화초등학교,37399,2767,5063,2767,5063,0,252
대흥,43194,30,363,30,363,0,12
대흥,43591,403,32,384,32,19,14
대흥식당,35688,47,23,46,23,1,2
대흥식당,35689,30,49,30,49,0,2
더리미경로당,43363,19,26,18,26,1,1
더리미경로당,43731,22,30,22,30,0,1
더리미미술관,43961,122,24,107,24,15,4
더리미미술관,43962,6,2,4,2,2,0
더리미장어마을,43680,6,43,6,43,0,1
더리미장어마을,43864,25,11,24,11,1,1
더샵그린스퀘어105동,92021,2025,214,2025,214,0,72
더샵그린스퀘어107동,92022,207,2763,207,2763,0,95
더샵그린애비뉴,38486,9517,8484,9515,8484,2,580
더샵그린애비뉴,38510,776,16,776,16,0,25
더샵그린워크1단지,38495,5572,2527,5561,2527,11,261
더샵부평센트럴시티(101동),40061,1861,2813,1861,2813,0,150
더샵부평센트럴시티(101동),40065,2680,1272,2680,1272,0,127
더샵부평센트럴시티(127동),40050,9603,15390,9571,15390,32,806
더샵센트럴시티204동,92020,74,2213,74,2213,0,73
더샵센트럴시티205동,92019,4970,2879,4970,2879,0,253
더샵송도마리나베이,38765,15,1286,15,1286,0,41
더샵송도마리나베이,38766,933,8,933,8,0,30
더샵송도프라임뷰20단지,38561,1374,4594,1367,4594,7,192
더샵엑스포빌리지,38480,8283,3621,8282,3621,1,384
더샵퍼스트파크13단지,38601,1174,259,1171,259,3,46
더샵퍼스트파크13단지,38602,113,666,113,666,0,25
더샵하버뷰,38485,11810,7812,11810,7812,0,632
더샵하버뷰,38487,3446,2230,3441,2230,5,183
더샵하버뷰(D13),38453,1550,1072,1540,1072,10,84
더샵하버뷰(D13),38466,1275,1858,1270,1858,5,101
더샵하버뷰(D14),38454,1033,693,1033,693,0,55
더샵하버뷰14단지,38504,1603,1358,1603,1358,0,95
더월드스테이트2단지,37657,871,367,854,367,17,39
더월드스테이트후문,37422,68,776,59,776,9,27
더포레스트아파트,39876,8240,1777,8240,1777,0,323
더포레스트아파트,39877,4817,8459,4817,8459,0,428
더프라우,38410,9408,25866,9407,25866,1,1137
더필립요양병원,40461,1984,4194,1984,4194,0,199
덕고개삼거리,43723,62,49,61,49,1,3
덕고개삼거리,43750,13,62,13,62,0,2
덕골,43397,23,6,23,6,0,0
덕골,43399,18,25,18,25,0,1
덕교3거리,35012,137,39,137,39,0,5
덕교동,35003,806,163,806,163,0,31
덕교동,35005,129,1363,129,1363,0,48
덕교동,35259,1390,313,1389,313,1,54
덕교삼거리,35214,37,209,37,209,0,7
덕신고등학교(강화읍교회),90228,19,127,18,127,1,4
덕신고등학교(강화읍교회),90229,133,148,133,148,0,9
덕유마을.설악마을,11187,2628,1355,2628,1355,0,128
덕유마을.설악마을,55073,1217,695,1216,695,1,61
덕음,43657,15,10,15,10,0,0
덕응,43983,8,16,8,16,0,0
덕응,43986,18,11,17,11,1,0
덕정가든,43173,0,20,0,20,0,0
덕정가든,43296,36,3,35,3,1,1
덕진사거리,43870,56,15,56,15,0,2
덕진사거리,90310,3,10,3,10,0,0
덕진진,43637,19,82,14,82,5,3
덕진진,43672,37,5,37,5,0,1
덕창기계,39723,176,46,176,46,0,7
덕포리,43006,378,219,375,219,3,19
덕포리,43100,183,267,179,267,4,14
덕하교앞,43449,4,42,4,42,0,1
덕하교앞,43727,20,38,19,38,1,1
덕화2리,43468,59,18,59,18,0,2
덕화2리,43730,5,27,5,27,0,1
덕화2리마을회관,43923,40,21,40,21,0,1
덕화2리마을회관,43924,4,21,4,21,0,0
덕화3리마을회관,43609,150,111,148,111,2,8
덕화3리입구,43469,7,10,7,10,0,0
덕화3리입구,43729,28,51,26,51,2,2
덕화교회앞,90398,1,42,1,42,0,1
덕화교회앞,90399,12,4,12,4,0,0
도간마을,43612,38,0,38,0,0,1
도간마을,43664,0,32,0,32,0,1
도감말,43733,15,3,15,3,0,0
도감말,43754,6,11,6,11,0,0
도곡한신아파트,23504,59,46,59,46,0,3
도담공원.푸르지오더베뉴,89397,4576,1892,4576,1892,0,208
도담공원.푸르지오더베뉴,89398,3017,4365,3017,4365,0,238
도담공원·인천이음중학교(서측),89482,2025,1889,2025,1889,0,126
도두리마을,41565,16472,1906,16472,1906,0,592
도두리마을,41566,2630,12566,2630,12566,0,490
도림고등학교,92066,122,209,122,209,0,10
도림동고개,39160,1183,668,1181,668,2,59
도림동고개,39161,660,1603,660,1603,0,73
도림동입구,39140,8183,1846,8183,1846,0,323
도림동입구,39141,5,2153,5,2153,0,69
도림아이파크아파트,39155,7662,3947,7656,3947,6,374
도림육교,39154,3547,6625,3547,6625,0,328
도림주공1단지,39152,15635,12317,15624,12317,11,901
도림주공1단지,39153,13927,11535,13913,11535,14,821
도림주공208동,39142,6712,3158,6708,3158,4,318
도림주공208동,39143,4715,7210,4714,7210,1,384
도림주공2단지,39146,4567,4488,4558,4488,9,292
도림주공2단지,39149,3719,2447,3715,2447,4,198
도림주철관1공장,89307,366,618,366,618,0,31
도림주철관공업(주),42293,3482,1167,3482,1167,0,149
도림포도원,39150,313,3666,310,3666,3,128
도림포도원,39151,387,400,387,400,0,25
도원고개(도원역),36001,3953,3299,3948,3299,5,233
도원고개(동구청방향),36170,50,47,50,47,0,3
도원동행정복지센터,35180,3142,2750,3136,2750,6,190
도원동행정복지센터,36128,92,331,92,331,0,13
도원동행정복지센터(앞),35788,113,163,113,163,0,8
도원동행정복지센터(앞),35798,196,129,196,129,0,10
도원역(인천축구전용경기장),35176,8051,5319,8030,5319,21,431
도원역(인천축구전용경기장),37549,1628,3680,1626,3680,2,171
도장골삼거리,44122,0,4,0,4,0,0
도장재마을,43167,18,2,18,2,0,0
도장재마을,43225,3,30,3,30,0,1
도화1동행정복지센터,37340,11381,9958,11361,9958,20,688
도화IC,37356,26062,20434,26055,20434,7,1499
도화e편한세상604동,37578,536,92,536,92,0,20
도화e편한세상아파트,37612,196,1605,196,1605,0,58
도화e편한세상아파트,37613,4614,1918,4612,1918,2,210
도화e편한세상아파트5단지,37624,3259,1518,3259,1518,0,154
도화e편한세상아파트6단지,37626,2380,3945,2380,3945,0,204
도화동신협(구박문여고),36003,10576,4615,10573,4615,3,490
도화동신협(구박문여고),37499,5034,7691,5031,7691,3,410
도화사거리.도화역,37390,856,805,856,805,0,53
도화사거리.도화역,37392,452,1177,452,1177,0,52
도화사거리·더샵인천스카이타워,37673,7290,4113,7284,4113,6,367
도화사거리·더샵인천스카이타워,37674,2792,6857,2785,6857,7,311
도화서희스타힐스,37625,1676,2515,1676,2515,0,135
도화역,37629,6293,7297,6293,7297,0,438
도화초등학교.수봉도서관,37366,7102,6389,7102,6389,0,435
도화초등학교.수봉도서관,37367,11561,12548,11553,12548,8,777
독골사거리,42175,2859,1372,2859,1372,0,136
독배로317번길(삼거리),37634,7465,217,7465,217,0,247
독장골,43351,1,21,1,21,0,0
독장골,43846,14,1,14,1,0,0
독정역(서구동구예비군훈련장),42377,4783,4717,4783,4717,0,306
독정역(서구동구예비군훈련장),42378,9580,5858,9571,5858,9,498
독정이고개,37234,29291,21062,29243,21062,48,1624
독정이고개,37238,19755,27113,19707,27113,48,1511
돈대마을,43925,29,1,24,1,5,0
돈대마을,43926,8,13,8,13,0,0
돈대모루,43422,1,6,1,6,0,0
돈대모루,43447,9,12,9,12,0,0
돌머루(대산종점),43707,91,80,90,80,1,5
돌산밑,35320,186,14,186,14,0,6
돌산밑,35396,12,235,12,235,0,7
돌성,43364,39,270,38,270,1,9
돌성,43587,205,64,205,64,0,8
돌팍재삼거리,35273,615,1101,614,1101,1,55
돌팍재삼거리,35277,956,696,953,696,3,53
돌팍재한뿌리,35304,201,298,201,298,0,16
돌팍재한뿌리,35315,125,382,125,382,0,16
동강리,35245,116,80,116,80,0,6
동강리,35246,59,85,58,85,1,4
동강리,35317,18,81,18,81,0,3
동강리,35393,134,27,128,27,6,5
동검도삼거리,43223,1,30,1,30,0,1
동검도삼거리,43642,64,1,63,1,1,2
동검리마을회관입구,90069,0,15,0,15,0,0
동검리마을회관입구,90070,9,0,9,0,0,0
동검리입구,43856,3,25,3,25,0,0
동검리입구,43877,21,17,21,17,0,1
동검리종점,43889,72,28,71,28,1,3
동검상회,43226,5,0,5,0,0,0
동검상회,43519,0,2,0,2,0,0
동광리어,41083,1170,564,1169,564,1,55
동광리어,41084,666,2162,666,2162,0,91
동광제일교회,40411,437,617,437,617,0,34
동교동삼거리,22012,6637,63,6637,63,0,216
동교동삼거리,23033,161,5068,161,5068,0,168
동구선거관리위원회,36110,3284,9267,3254,9267,30,404
동구청,36011,564,584,564,584,0,37
동구청소년수련관.달동네박물관,36026,16235,14974,16124,14974,111,1006
동국제강,36068,1945,3471,1938,3471,7,174
동국제강,36074,315,161,315,161,0,15
동국제강후문,36069,127,710,127,710,0,27
동국제강후문,36070,949,119,949,119,0,34
동남스포피아,38226,9948,7644,9948,7644,0,567
동남스포피아,38227,10358,8800,10358,8800,0,618
동남아파트,38267,1166,6608,1166,6608,0,250
동남아파트,38268,3082,1114,3082,1114,0,135
동남아파트,70039,603,622,603,622,0,39
동남아파트(무지개아파트),38337,998,4166,982,4166,16,166
동녘개,90147,1,9,1,9,0,0
동녘개,90148,31,21,31,21,0,1
동녘마을입구,39660,33,697,33,697,0,23
동들머리,43705,6,7,5,7,1,0
동들머리,43885,17,34,17,34,0,1
동막교회,43499,14,62,13,62,1,2
동막교회,43514,57,9,57,9,0,2
동막역(1번출구),38039,35975,54617,35916,54617,59,2922
동막역(3번출구),38433,51713,27572,51691,27572,22,2557
동막역(4번출구),38338,9254,976,9254,976,0,330
동막초등학교,38054,913,4159,913,4159,0,163
동막해변,43408,59,99,58,99,1,5
동막해변,43511,167,66,165,66,2,7
동문아파트,42436,13718,13989,13717,13989,1,893
동방중학교,92038,486,385,486,385,0,28
동방초등학교,92037,53,200,53,200,0,8
동보2차아파트,41053,35,655,35,655,0,22
동보2차아파트,41059,856,102,856,102,0,30
동보노빌리티,35488,3246,3147,3242,3147,4,206
동보노빌리티,35489,3579,2643,3579,2643,0,200
동보아파트,39125,2937,5408,2937,5408,0,269
동보아파트,39126,5288,1797,5288,1797,0,228
동보아파트,41056,4331,546,4331,546,0,157
동보아파트,41063,1070,3856,1070,3856,0,158
동보아파트,41136,335,1007,333,1007,2,43
동보아파트,41143,12522,16931,12515,16931,7,950
동보아파트,70040,331,668,331,668,0,32
동보아파트후문,41129,1134,311,1125,311,9,46
동부아파트,36052,1284,2310,1274,2310,10,115
동부아파트,37192,487,466,487,466,0,30
동산고,36018,12479,3882,12468,3882,11,527
동산고등학교,36021,5679,12856,5667,12856,12,597
동산교회,36010,1668,2802,1666,2802,2,144
동산교회,36012,2950,3634,2941,3634,9,212
동산교회,90303,1,1,1,1,0,0
동산리마을회관,90302,16,4,16,4,0,0
동산리입구,90291,6,8,6,8,0,0
동산중고등학교(재능대정문),36029,8722,968,8722,968,0,312
동산휴먼시아2단지,36022,2889,508,2889,508,0,109
동산휴먼시아2단지,36023,926,4274,926,4274,0,167
동서식품,40623,2506,2346,2503,2346,3,156
동서식품,40624,1760,3358,1759,3358,1,165
동성.길훈아파트,42495,3263,5529,3262,5529,1,283
동성아파트,42496,4778,2368,4778,2368,0,230
동수교회,40184,159,1085,151,1085,8,40
동수역,40108,3092,5280,3092,5280,0,270
동수역,40110,7261,5783,7261,5783,0,420
동수역,40124,2043,12164,2043,12164,0,458
동수치안센터,40188,8607,8876,8606,8876,1,563
동수치안센터,40189,11420,12576,11419,12576,1,774
동아.팬더아파트,39233,7026,10161,7026,10161,0,554
동아.팬더아파트,39236,10439,5891,10439,5891,0,526
동아2단지정문,40324,1359,441,1359,441,0,58
동아금호아파트,38344,5762,12515,5762,12515,0,589
동아금호아파트,38347,7335,2634,7327,2634,8,321
동아아파트,37248,932,1207,932,1207,0,69
동아아파트,41070,3176,1109,3174,1109,2,138
동아아파트,41072,1124,2587,1122,2587,2,119
동아아파트,41403,1093,3954,1093,3954,0,162
동아아파트,42404,3311,4056,3311,4056,0,237
동아아파트,42406,5834,3154,5834,3154,0,289
동아아파트후문,40257,2264,2726,2261,2726,3,160
동아아파트후문,40258,2531,1725,2524,1725,7,137
동아전기,42647,696,966,695,966,1,53
동아전기,42725,1297,987,1294,987,3,73
동아정밀,42037,1288,2821,1288,2821,0,132
동아풍림아파트,37037,14174,17520,14174,17520,0,1022
동암국민주택,40014,3116,737,3116,737,0,124
동암국민주택,40015,621,1870,621,1870,0,80
동암남부역,40034,38760,27245,38760,27245,0,2129
동암남부역,40797,133649,113902,133424,113902,225,7985
동암남부역,40861,724,6725,724,6725,0,240
동암남부역,40862,18785,13429,18785,13429,0,1039
동암북부역,40013,31055,15727,31004,15727,51,1509
동암북부역,40035,10151,29575,10137,29575,14,1281
동암북부역광장,40800,70859,56240,70630,56240,229,4099
동암사거리,40001,14008,14901,14007,14901,1,932
동암사거리,40003,3394,5779,3388,5779,6,295
동양도서관,41522,6756,3925,6755,3925,1,344
동양도서관(휴먼빌아파트),41523,4081,5012,4081,5012,0,293
동양엔파트4단지,42820,2600,3896,2599,3896,1,209
동양엔파트4단지,42837,3873,1909,3873,1909,0,186
동양엔파트5단지,42986,2450,3189,2450,3189,0,181
동양자이입구,41554,2696,3644,2696,3644,0,204
동양자이입구,41555,2962,2515,2962,2515,0,176
동양장사거리,37301,7615,6281,7615,6281,0,448
동양주공1.2단지,41372,10933,2889,10932,2889,1,445
동양주공1.2단지,41373,2521,7522,2521,7522,0,323
동양지구1단지정문,41521,827,2100,827,2100,0,94
동양지구입구,41445,4492,579,4492,579,0,163
동양지구입구,41446,1223,5961,1223,5961,0,231
동양하이테크,42966,26,233,26,233,0,8
동원로얄듀크마리나포레,35890,1202,516,1202,516,0,55
동원로얄듀크마리나포레,35891,329,1171,329,1171,0,48
동원아파트,25166,197,289,197,289,0,15
동원아파트,25167,395,89,395,89,0,15
동원아파트,37376,4377,1928,4375,1928,2,203
동원아파트,37379,1681,2821,1681,2821,0,145
동인천,35188,28577,35079,28577,35079,0,2053
동인천(우리은행앞),35517,759,507,744,507,15,40
동인천동행정복지센터,35795,12,292,12,292,0,9
동인천동행정복지센터,35805,78,107,78,107,0,5
동인천역,35185,102551,47844,102447,47844,104,4851
동인천역,35187,4974,10281,4973,10281,1,492
동인천역,35191,71839,88138,71689,88138,150,5160
동인천역,35192,10965,22729,10936,22729,29,1086
동인천역북광장,36136,23411,17078,23359,17078,52,1306
동인천역북광장,36137,30968,15132,30926,15132,42,1487
동인천중학교,39229,1391,869,1385,869,6,72
동인천중학교,39230,1871,1121,1866,1121,5,96
동일방직,36031,3302,3260,3286,3260,16,211
동일방직,36032,3574,2793,3573,2793,1,205
동일아파트,35177,662,1444,659,1444,3,67
동작세무서,20005,32,425,32,425,0,14
동주농장,43349,3,11,3,11,0,0
동주농장,43401,24,2,23,2,1,0
동촌,43407,98,1,96,1,2,3
동촌,43793,2,71,2,71,0,2
동춘2동행정복지센터,38045,1127,6053,1127,6053,0,231
동춘2동행정복지센터,38046,5337,683,5337,683,0,194
동춘동종점,38037,550,1077,541,1077,9,52
동춘동차고지,38569,621,398,621,398,0,32
동춘롤러경기장,38704,282,552,282,552,0,26
동춘마을아파트,38082,6915,5414,6908,5414,7,397
동춘마을아파트,38087,3734,6867,3734,6867,0,341
동춘역,38346,33014,21860,32931,21860,83,1770
동춘역(이마트),38060,13912,591,13912,591,0,467
동춘역(이마트.스퀘어원),38070,29378,38629,29374,38629,4,2193
돼지슈퍼.간동입구,80019,55,874,55,874,0,29
두두미마을,43289,6,0,6,0,0,0
두두미마을,43869,0,5,0,5,0,0
두밀경노당,89328,9,171,9,171,0,5
두밀경노당,89331,132,10,131,10,1,4
두산아파트,40564,2197,3794,2197,3794,0,193
두산위브아파트,37043,14956,8756,14956,8756,0,764
두산위브아파트,40630,11522,568,11522,568,0,390
두산위브아파트,40648,404,1331,404,1331,0,55
두운1리마을회관앞,90047,2,60,2,60,0,2
두운1리마을회관앞,90048,26,4,26,4,0,0
두운리,43034,139,92,139,92,0,7
두운리,43540,135,221,135,221,0,11
둑실경로당,41498,5,35,5,35,0,1
둑실경로당,41514,68,0,68,0,0,2
둑실동(아라마루전망대),41494,1,63,1,63,0,2
둑실동(아라마루전망대),41512,179,3,179,3,0,5
둑실동회차지,41500,87,36,87,36,0,3
둥개마을오거리,35861,9,43,9,43,0,1
둥개마을오거리,35862,16,2,16,2,0,0
둥깨마을입구(세븐일레븐),35721,31,12,29,12,2,1
둥깨마을입구(세븐일레븐),35722,68,26,67,26,1,3
둥깨마을입구(용성철강),35723,2,24,2,24,0,0
둥깨마을입구(용성철강),35724,3,12,3,12,0,0
뒤골입구,35668,19,0,19,0,0,0
뒤골입구,35669,3,29,3,29,0,1
뒷골 입구,90377,21,26,21,26,0,1
뒷골 입구,90380,15,0,15,0,0,0
뒷방죽들,39959,835,20,835,20,0,27
뒷방죽들,39960,6128,7842,6128,7842,0,450
드라이빙센터,35589,50,1705,50,1705,0,56
드림로갈산교,41342,335,41,335,41,0,12
드림로갈산교,41343,47,925,47,925,0,31
드림파크야생화단지,89363,2109,16,2109,16,0,68
드림파크야생화단지,89364,11,2247,10,2247,1,72
드무리해변,44011,46,467,46,467,0,16
드무리해변,44012,508,50,508,50,0,18
디에스솔텍,39035,2947,2273,2947,2273,0,168
디에스솔텍,39038,2045,1984,2045,1984,0,129
디에트로더힐,89455,4611,5191,4611,5191,0,316
디에트로더힐,89464,721,4,721,4,0,23
디에트르더힐(고산터널),89396,4406,6703,4406,6703,0,358
뗏마루어린이공원·신화아파트,39405,4390,6690,4367,6690,23,357
라마다 인천호텔,92075,196,1132,196,1132,0,42
라이크홈기숙사앞,39993,1485,1419,1485,1419,0,93
라이크홈기숙사앞,39994,2171,1533,2171,1533,0,119
라이크홈기숙사앞,39995,865,65,865,65,0,30
라이크홈기숙사앞,39996,32,637,32,637,0,21
라이프쇼핑앞,35070,6149,5693,6074,5693,75,382
라이프아파트,35060,131,5873,130,5873,1,193
라이프아파트,35062,13614,94,13547,94,67,442
"래미안아파트,파이낸셜뉴스",22905,7504,4252,7504,4252,0,379
래미안아파트파이낸셜뉴스,31072,1083,2556,1083,2556,0,117
래미안아파트파이낸셜뉴스,32002,3276,2066,3276,2066,0,172
랜드마크시티1호수변공원,38767,210,218,210,218,0,13
랜드마크시티센트럴더샵,38636,107,4187,107,4187,0,138
랜드마크시티센트럴더샵(106동),38665,1291,7975,1290,7975,1,298
랜드마크시티센트럴더샵(106동),38666,7855,931,7845,931,10,283
랜드마크시티센트럴더샵(203동),38645,15632,1318,15632,1318,0,546
랜드마크시티센트럴더샵(203동),38650,1292,13848,1292,13848,0,488
럭키아파트,23488,263,130,263,130,0,12
럭키아파트,38115,4600,159,4600,159,0,153
럭키아파트,38132,898,8540,898,8540,0,304
레이크파크,42840,1412,4288,1409,4288,3,183
레전드호텔,35639,1447,1630,1447,1630,0,99
레전드호텔,35640,72,382,72,382,0,14
레지던스라이크홈,92012,509,5810,509,5810,0,203
로봇랜드입구,89022,3595,74,3595,74,0,118
로봇랜드입구,89023,8,2522,8,2522,0,81
로봇타워,89301,4,542,4,542,0,17
로봇타워,89302,621,46,621,46,0,21
로얄금속,40599,5669,3602,5661,3602,8,299
로얄아파트,37247,33058,17230,33029,17230,29,1622
로얄아파트,37424,566,229,551,229,15,25
로얄타운,42047,1999,3160,1967,3160,32,166
로얄호텔,43542,3,16,2,16,1,0
로얄호텔,43878,5,17,4,17,1,0
롯데마트,35108,3116,4460,3116,4460,0,244
롯데마트,41390,675,15,675,15,0,22
롯데마트,41391,26,2721,25,2721,1,88
롯데마트,42829,19454,10133,19454,10133,0,954
롯데마트,42838,9798,21655,9798,21655,0,1014
롯데마트계양점(고용복지센터),41227,26427,16568,26390,16568,37,1386
롯데마트계양점(고용복지센터),41424,10602,18690,10596,18690,6,944
롯데마트송도점,38523,2615,799,2615,799,0,110
롯데몰.김포공항,25174,369,1461,369,1461,0,59
롯데백화점(인천터미널),37513,174509,163191,174377,163191,132,10893
롯데백화점(인천터미널),39588,169481,117646,169386,117646,95,9262
롯데슈퍼,38072,8985,3113,8982,3113,3,390
롯데슈퍼,38074,2889,7482,2874,7482,15,334
롯데슈퍼,42206,2460,4155,2457,4155,3,213
롯데슈퍼,42207,6638,2334,6632,2334,6,289
롯데아파트,38110,7347,9624,7341,9624,6,547
롯데우람아파트,42152,4707,6787,4706,6787,1,370
롯데우람아파트,42603,3380,5117,3348,5117,32,274
롯데월드타워,37327,2416,5039,2416,5039,0,240
롯데캐슬,39795,463,335,463,335,0,25
롯데캐슬,39796,2944,1293,2944,1293,0,136
롯데캐슬,39797,531,100,530,100,1,20
롯데캐슬,39798,179,589,179,589,0,24
롯데캐슬,42835,7707,5953,7707,5953,0,440
롯데캐슬,42884,5317,9762,5317,9762,0,486
롯데캐슬,42999,863,2932,863,2932,0,122
롯데캐슬.모래내시장,39309,55024,20480,54923,20480,101,2435
롯데캐슬·모래내시장·구월시장,39310,29464,52694,29442,52694,22,2650
롯데캐슬캠퍼스타운,39977,16,877,16,877,0,28
롯데캐슬캠퍼스타운,39978,2690,2663,2690,2663,0,172
롯데캐슬후문,39285,4171,4220,4168,4220,3,270
루에블리아파트,89283,2865,4531,2860,4531,5,238
루에블리아파트,89284,6149,6223,6146,6223,3,399
루원더퍼스트아파트,89107,3705,6531,3705,6531,0,330
루원더퍼스트아파트,89108,8715,1994,8715,1994,0,345
루원더퍼스트아파트105동앞,89378,199,1186,199,1186,0,44
루원숲속마을,89383,447,1411,446,1411,1,59
루원숲속마을,89384,4,397,4,397,0,12
루원시티2차리더스뷰아파트,89072,13352,13910,13341,13910,11,879
루원시티사거리,89076,1548,1206,1541,1206,7,88
루원시티사거리,89077,355,1563,354,1563,1,61
루원시티프라디움,89150,13681,3778,13680,3778,1,563
루원시티프라디움105동,89308,9465,10396,9453,10396,12,640
루원시티프라디움105동,89309,3002,5960,3000,5960,2,289
루원이편한세상하늘채(107동),42225,13132,16464,13110,16464,22,954
루원이편한세상하늘채(112동),42721,4156,2092,4150,2092,6,201
루원이편한세상하늘채(125동),42216,5423,2641,5405,2641,18,260
루원제일풍경채정문앞,89040,3634,10984,3625,10984,9,471
루원중학교,89493,1108,250,1108,250,0,43
루원중학교,89494,52,820,52,820,0,28
루원지웰시티푸르지오,42228,8428,8385,8403,8385,25,542
루원호반베르디움,89149,4746,12140,4740,12140,6,544
루원호반베르디움104동,89368,1043,1511,1043,1511,0,82
리안월드입구,90177,47,44,47,44,0,2
리안월드입구,90178,27,29,26,29,1,1
린나이코리아,40011,3,331,3,331,0,10
린나이코리아,40012,511,18,511,18,0,17
린스트라우스,42881,8025,3395,8021,3395,4,368
린스트라우스정문,42795,6619,4104,6619,4104,0,345
린스트리우스,42831,3339,3371,3339,3371,0,216
마그네,43028,177,204,177,204,0,12
마그네다리,43158,280,195,280,195,0,15
마그네다리,43900,32,37,32,37,0,2
마그네사거리,43029,358,295,356,295,2,21
마그네사거리,43030,438,441,438,441,0,28
마니교통차고지,89496,368,54,368,54,0,13
마니산상회,43417,99,44,99,44,0,4
마니산상회,43443,31,57,30,57,1,2
마니산입구,43102,157,547,155,547,2,22
마니산입구,43103,668,213,664,213,4,28
마당개,35681,63,50,59,50,4,3
마당개,35697,84,25,84,25,0,3
마린월드,70004,967,166,943,166,24,36
마린월드,70029,6,105,1,105,5,3
마미,43747,27,24,27,24,0,1
마미,43765,4,12,4,12,0,0
마송,80131,879,4130,879,4130,0,161
마송,80132,3509,746,3509,746,0,137
마시란,35424,120,324,120,324,0,14
마시란,35425,275,71,275,71,0,11
마을금고,40528,1122,5188,1122,5188,0,203
마을회관,43314,20,0,20,0,0,0
마을회관,43773,0,9,0,9,0,0
마을회관입구,35024,505,2392,503,2392,2,93
마을회관입구,35402,1037,160,1037,160,0,38
마장공원,40286,6633,27,6614,27,19,214
마장포,35679,17,10,17,10,0,0
마장포,35699,277,68,262,68,15,11
마장포고개,35677,43,34,43,34,0,2
마장포고개,35701,45,18,45,18,0,2
마전고등학교,42752,127,7583,127,7583,0,248
마전고등학교,42753,6018,226,6018,226,0,201
마전역,42412,3292,8606,3291,8606,1,383
마전역,42413,19455,4932,19453,4932,2,786
마전주공아파트,42420,27,163,27,163,0,6
마전지구대원아파트,42481,5851,69,5851,69,0,190
마전지구대원아파트,89446,15,5134,15,5134,0,166
마전지구버스차고지,89259,4175,294,4174,294,1,144
마전지구버스차고지,89345,34,2420,34,2420,0,79
마전초등학교,42408,4987,5409,4987,5409,0,335
마포역,14001,2,477,2,477,0,15
마포역,14002,405,1,405,1,0,13
막촌,43460,344,24,319,24,25,11
막촌,43776,2,143,2,143,0,4
만석동행정복지센터,36046,4017,1505,4001,1505,16,178
만석부두,36076,405,3398,405,3398,0,122
만석부두,36079,4582,1551,4579,1551,3,197
만석비치타운,36106,659,5505,659,5505,0,198
만석비치타운,36126,1641,1056,1641,1056,0,87
만석삼거리,36185,2399,7065,2364,7065,35,305
만석삼거리,36186,946,1481,945,1481,1,78
만석주공,36057,13864,2366,13834,2366,30,523
만석초등학교,36056,536,207,530,207,6,23
만석초등학교,36187,3,40,3,40,0,1
만수1동행정복지센터,39294,12270,5131,12270,5131,0,561
만수2동행정복지센터·포레시안,39731,16836,9563,16836,9563,0,851
만수2동행정복지센터·포레시안,39735,10194,11456,10194,11456,0,698
만수3동주민센터,39425,18923,25043,18862,25043,61,1418
만수3동주민센터,39427,30879,12407,30850,12407,29,1396
만수3동주민센터,39544,485,117,479,117,6,19
만수3동주민센터,39545,76,1076,72,1076,4,37
만수4동주민센터,39452,6643,6714,6625,6714,18,430
만수4동주민센터,39454,6564,11664,6549,11664,15,588
만수6동주민센터입구,39277,4855,12759,4853,12759,2,568
만수7.8단지앞,39497,838,2052,838,2052,0,93
만수7.8단지앞,39635,2889,2540,2889,2540,0,175
만수북중학교,39468,1155,1820,1155,1820,0,95
만수북중학교,39469,1961,627,1961,627,0,83
만수북초등학교,39420,6052,4556,6016,4556,36,342
만수소방서,39428,8437,15660,8393,15660,44,777
만수소방서,39433,33604,12454,33526,12454,78,1485
만수신동아아파트·동인천고,39485,10111,9727,9456,9727,655,639
만수신동아아파트·동인천고,39578,406,55,400,55,6,14
만수역,39385,2542,43,2542,43,0,83
만수역,39388,284,17671,278,17671,6,579
만수종합시장,39451,28326,9562,28173,9562,153,1222
만수종합시장,39592,8628,21950,8566,21950,62,986
만수주공1단지,39401,3156,3282,3156,3282,0,207
만수주공320동앞,39431,1457,1714,1457,1714,0,102
만수주공4단지,39440,8126,5545,8116,5545,10,441
만수주공4단지,39443,10179,9190,10168,9190,11,624
만수주공정문,39408,10273,7844,10242,7844,31,584
만수주공정문,39410,2963,3281,2953,3281,10,201
만수주공후문,39435,4303,10365,4293,10365,10,473
만수주공후문,39438,13396,3866,13342,3866,54,556
만수중(대토단지),39400,284,1423,284,1423,0,55
만수중학교후문,39745,131,884,131,884,0,32
만수초등학교,39303,1569,4956,1569,4956,0,210
만수초등학교,39307,659,863,657,863,2,49
만수치안센터,39455,826,485,826,485,0,42
만월종합사회복지관,92065,3,1550,3,1550,0,50
만월중학교,39962,2145,335,2145,335,0,80
만월중학교,39963,128,2578,128,2578,0,87
만의골입구,39666,73,85,73,85,0,5
만의골입구,39672,1,74,1,74,0,2
만정낚시터,35682,132,57,132,57,0,6
만정낚시터,35696,8,81,8,81,0,2
만정낚시터입구,35683,40,82,39,82,1,3
만정낚시터입구,35695,74,65,74,65,0,4
망양돈대,90224,2,27,2,27,0,0
망양돈대,90225,22,5,21,5,1,0
망월3리,43332,165,112,164,112,1,8
망월3리,43580,0,37,0,37,0,1
망월입구,43117,3,0,3,0,0,0
망월입구,43576,17,35,17,35,0,1
망월입구,43790,9,25,9,25,0,1
망월종점,43788,3,10,3,10,0,0
매음1리마을회관,90173,15,24,15,24,0,1
매음1리마을회관,90174,23,7,22,7,1,0
매음3리마을회관(민머루),90321,13,10,13,10,0,0
매음3리마을회관(민머루),90322,26,1,25,1,1,0
매제미고개,43837,17,10,17,10,0,0
매제미고개,43988,2,7,2,7,0,0
먼우금사거리,38114,6680,5237,6665,5237,15,384
먼우금초등학교,38021,3278,11160,3278,11160,0,465
메이루즈커낼파크뷰,42747,3632,9918,3626,9918,6,437
메이루즈커낼파크뷰,42762,10554,3774,10550,3774,4,462
메이루즈커낼파크뷰정문,42794,4094,4429,4094,4429,0,274
메제미,43302,135,24,134,24,1,5
메제미,43598,22,104,22,104,0,4
면사무소입구,90018,13,184,13,184,0,6
면사무소입구,90019,103,12,99,12,4,3
면허시험장,39006,1922,1842,1922,1842,0,121
명가빌라(회차),37553,2701,2250,2673,2250,28,159
명보주택앞,43979,5,17,5,17,0,0
명보주택앞,43984,56,11,53,11,3,2
명신여자고등학교,40289,17952,4996,17946,4996,6,740
명신여자고등학교,40291,5418,12502,5416,12502,2,578
명신초등학교,43394,130,0,130,0,0,4
명신초등학교,43803,3,118,3,118,0,3
명진부페,43323,0,1,0,1,0,0
명진부페,43632,23,20,23,20,0,1
명현중학교,41405,2558,7817,2558,7817,0,334
명현초등학교,41559,5988,1758,5988,1758,0,249
명현초등학교,41560,1314,4335,1314,4335,0,182
명현초등학교(효성지구대),41069,9,923,7,923,2,30
모다아울렛,89190,2495,3146,2495,3146,0,181
모래내시장,39295,14748,13195,14730,13195,18,901
모래내시장,39298,12982,10551,12952,10551,30,759
모래내시장,39344,6755,6293,6755,6293,0,420
모래내시장,39350,11986,13001,11965,13001,21,806
모래내시장역(1번출구),39338,11550,9642,11532,9642,18,683
모래내시장역(2번출구),39909,9843,12382,9839,12382,4,716
모래내시장역(3번출구),39339,35202,33794,35145,33794,57,2225
모래내시장역(4번출구),39335,2115,6275,2109,6275,6,270
모래방죽사거리,89228,1800,1182,1800,1182,0,96
모래방죽사거리,89229,3477,3413,3472,3413,5,222
모름말,90255,4,0,3,0,1,0
모름말,90311,2,8,2,8,0,0
모리부락입구,90304,13,0,13,0,0,0
모아아파트,70033,248,652,248,652,0,29
모아아파트.세종프라자,70034,638,260,638,260,0,28
모현,43659,3,292,3,292,0,9
모현,43689,276,8,274,8,2,9
목개마을,90153,2,10,2,10,0,0
목개마을,90154,28,17,28,17,0,1
목너머,35863,50,9,50,9,0,1
목너머,35864,3,36,3,36,0,1
목련어린이집,40824,10053,3408,10045,3408,8,434
목비고개,43032,55,167,55,167,0,7
목비고개,43272,236,94,236,94,0,10
목상교입구,41493,21,0,21,0,0,0
목상교입구,41519,0,17,0,17,0,0
목상교차로,41636,10,281,10,281,0,9
목상교차로,41637,203,2853,203,2853,0,98
목상동(새봄농원입구),41323,0,41,0,41,0,1
목상동(새봄농원입구),41324,72,8,72,8,0,2
목상동마을입구,41318,1,172,1,172,0,5
목상동마을입구,41517,161,13,161,13,0,5
목상동솔밭.이주단지입구,41316,1241,91,1235,91,6,42
목상동솔밭.이주단지입구,41317,95,836,95,836,0,30
목장앞,43503,0,7,0,7,0,0
목장앞,43688,9,2,9,2,0,0
목재단지,42036,423,466,423,466,0,28
목재부두사거리,42949,1,320,1,320,0,10
목재부두사거리,42960,79,43,79,43,0,3
목화빌라,37545,0,438,0,438,0,14
목화예식장,39446,15422,13314,15422,13314,0,926
목화예식장,39448,13746,19263,13712,19263,34,1064
무내미마을,39496,366,764,364,764,2,36
무내미마을,40106,188,2705,187,2705,1,93
무선내,44199,24,18,24,18,0,1
무의공영주차장,35871,5,13,5,13,0,0
무의도입구,35001,3038,242,3038,242,0,105
무의도입구,35002,407,3312,407,3312,0,119
무의도주민자치센터,35738,400,55,398,55,2,14
무의도주민자치센터,35739,25,219,25,219,0,7
무지개.한양8차아파트,40271,6701,4069,6701,4069,0,347
무지개.한양8차아파트,40276,5993,9670,5993,9670,0,505
무지개아파트,38366,3603,2734,3599,2734,4,204
무지개아파트(동남아파트),38042,6372,1244,6363,1244,9,245
무학리입구,90276,45,41,45,41,0,2
묵골,43498,19,5,17,5,2,0
묵골,43684,14,23,7,23,7,1
문남마을,38250,8043,5098,8043,5098,0,423
문남초등학교,38214,2399,2136,2399,2136,0,146
문남초등학교,38216,2507,3486,2507,3486,0,193
문말3거리,44084,4,0,2,0,2,0
문말삼거리,44001,262,15,262,15,0,8
문말삼거리,44002,28,260,28,260,0,9
문산교회앞,43340,20,34,16,34,4,1
문산교회앞,43589,40,50,30,50,10,2
문산리마을회관,43101,79,320,78,320,1,12
문일여고·하우스토리만수아파트,39313,1362,4142,1361,4142,1,177
문일여고·하우스토리만수아파트,39314,5529,808,5521,808,8,204
문일여자고등학교후문,39685,2603,3694,2602,3694,1,203
문학경기장(X게임장),37643,66,206,66,206,0,8
문학경기장(박태환수영장),38310,3662,2307,3656,2307,6,192
문학경기장(박태환수영장),38311,908,4135,908,4135,0,162
문학경기장(박태환수영장),38329,1502,1476,1502,1476,0,96
문학경기장(박태환수영장),38423,781,1450,780,1450,1,71
문학경기장(야구장),37144,5553,11440,5536,11440,17,548
문학경기장(월드컵경기장),37157,4727,9216,4723,9216,4,449
문학경로당,37087,4935,2990,4935,2990,0,255
문학경로당,37088,4344,3660,4344,3660,0,258
문학고개,37056,2595,2794,2595,2794,0,173
문학고개,37057,2831,3333,2831,3333,0,198
문학고개,37101,3502,4159,3483,4159,19,247
문학우체국,37520,3967,5046,3967,5046,0,290
문학우체국,37521,5182,3044,5182,3044,0,265
문학정보고입구,37107,4338,5733,4338,5733,0,324
문학정보고입구,37108,6537,2291,6537,2291,0,284
문학초등학교,37105,19333,8259,19283,8259,50,890
문학초등학교,37110,8616,15622,8615,15622,1,781
문현,43005,111,81,110,81,1,6
문현,43164,60,61,60,61,0,3
문현,43195,116,7,113,7,3,3
문현,43321,6,133,6,133,0,4
문화교회,40173,308,231,308,231,0,17
문화교회,40174,10081,11774,10067,11774,14,705
문화예술회관,39197,3157,5910,3149,5910,8,292
문화예술회관,39199,697,684,693,684,4,44
물류단지D블럭앞,35604,403,2,403,2,0,13
물류단지F블럭앞,35603,10,552,10,552,0,18
물왕TG(미정차),70223,1,0,1,0,0,0
미관광장,38508,32,139,32,139,0,5
미관광장,38512,21,58,21,58,0,2
미단교회사거리,35664,61,51,61,51,0,3
미단교회사거리,35665,2,23,2,23,0,0
미도아파트,37446,1233,1557,1233,1557,0,90
미도아파트,41027,9778,3016,9761,3016,17,412
미도아파트,41028,3588,9783,3579,9783,9,431
미래빌라,36088,6730,891,6724,891,6,245
미래빌라,36089,1416,4805,1416,4805,0,200
미래타운1.2단지,40683,3686,19021,3686,19021,0,732
미래타운1.2단지,40684,14448,2430,14448,2430,0,544
미래타운5단지,40672,1007,3660,1007,3660,0,150
미래타운5단지501동,40662,6035,291,6035,291,0,204
미래타운5단지505동,40669,5376,3076,5376,3076,0,272
미래테크원,92015,2522,1040,2522,1040,0,114
미루지,43420,18,18,18,18,0,1
미루지,43522,17,13,17,13,0,0
미륭아파트,36138,3265,655,3230,655,35,126
미륭아파트,36139,898,3185,887,3185,11,131
미림극장,36008,3441,8038,3417,8038,24,370
미림극장,36009,8778,2541,8720,2541,58,365
미림극장입구,36141,281,470,273,470,8,24
미산초등학교,40378,7672,8774,7656,8774,16,530
미송초등학교,38654,15998,1365,15992,1365,6,560
미송초등학교(하행),38653,2349,8657,2344,8657,5,355
미주탕,42123,2975,10793,2963,10793,12,444
미주탕,42124,11316,5290,11272,5290,44,535
미추홀경찰서(장미아파트),37524,767,4096,767,4096,0,156
미추홀공원,38368,9130,3105,9111,3105,19,394
미추홀구청,37304,5379,4181,5379,4181,0,308
미추홀구청,37307,1067,2320,1061,2320,6,109
미추홀구청입구,37306,9511,18270,9506,18270,5,896
미추홀구청입구,37312,10424,10718,10412,10718,12,682
미추홀구평생학습관,37073,5979,6244,5979,6244,0,394
미추홀도서관·인천신월초등학교,39270,3736,8334,3736,8334,0,389
미추홀서사거리,37678,199,1148,199,1148,0,43
미추홀아파트,40250,200,478,200,478,0,21
미추홀아파트,40254,242,362,242,362,0,19
미추홀외고,39689,449,868,449,868,0,42
미추홀외고,39690,751,494,751,494,0,40
미추홀퍼스트(2단지),37220,8606,3867,8551,3867,55,402
미추홀퍼스트(2단지),37642,3917,9124,3905,9124,12,420
미추홀퍼스트2단지,37646,2747,426,2747,426,0,102
미추홀퍼스트3단지,37647,644,3217,644,3217,0,124
민머루해수욕장,90336,10,4,10,4,0,0
민방위교육장,38610,63,719,63,719,0,25
민방위교육장,38611,693,459,693,459,0,37
민방위교육장,39733,8511,2421,8511,2421,0,352
민방위교육장,39734,49,2464,49,2464,0,81
민방위교육장입구,41043,1869,5466,1864,5466,5,236
바로크아파트,42530,827,635,826,635,1,47
박공현,43228,68,6,65,6,3,2
박공현,43294,18,46,18,46,0,2
박문여자고등학교,39799,1595,178,1595,178,0,57
박문여자고등학교,39800,1187,1162,1187,1162,0,75
박문중학교,39844,805,463,805,463,0,40
박문중학교,39847,621,3665,621,3665,0,138
박문중학교정문,39860,3714,327,3713,327,1,130
박문중학교후문,39859,633,132,633,132,0,24
박물관앞,43668,17,161,16,161,1,5
박물관앞,43698,232,14,227,14,5,7
박촌마을입구,35670,171,12,171,12,0,5
박촌마을입구,35671,3,204,3,204,0,6
박촌역,41309,16657,21575,16648,21575,9,1233
박촌역,41310,17289,11455,17289,11455,0,927
반달마을.법원.검찰청,55014,1471,4193,1471,4193,0,182
반도유보라,42904,426,1458,426,1458,0,60
반도유보라,42905,2416,445,2416,445,0,92
반도유보라,42963,2487,1182,2483,1182,4,118
반도유보라,42985,3420,1408,3420,1408,0,155
반디모텔,44126,6,0,6,0,0,0
반디모텔,44170,0,2,0,2,0,0
반찬단지,89426,201,162,201,162,0,11
반찬단지,89427,327,46,327,46,0,12
반포역,31034,262,2780,262,2780,0,98
반포역,31035,4019,93,4019,93,0,132
발전소삼거리,44115,37,56,36,56,1,3
밝게,43990,34,2,34,2,0,1
밝게,43991,1,36,1,36,0,1
밤나무골,43022,96,92,92,92,4,6
밤나무골,43023,153,78,153,78,0,7
방개마을,90141,54,10,43,10,11,2
방개마을,90142,2,18,0,18,2,0
방아머리,62008,249,23,249,23,0,8
방아머리,62032,55,133,55,133,0,6
방아머리선착장,62007,16,336,16,336,0,11
방아머리제1주차장,62031,25,291,25,291,0,10
방아머리제1주차장,62041,410,71,410,71,0,15
방죽골,39763,2183,2860,2173,2860,10,162
방죽골,39764,706,2107,706,2107,0,90
방죽말,43027,81,76,80,76,1,5
방죽말,43214,46,134,43,134,3,5
방죽삼거리,39173,391,1001,391,1001,0,44
방죽삼거리,39174,612,483,612,483,0,35
방죽삼거리,42681,1682,439,1678,439,4,68
방죽삼거리,42683,936,1591,936,1591,0,81
방촌공원,40419,3300,3088,3300,3088,0,206
방축삼거리,36159,652,358,652,358,0,32
방축삼거리,36190,83,15,83,15,0,3
방파제입구,35048,2,684,2,684,0,22
방화동도시개발11단지,25026,749,47,749,47,0,25
방화중학교,25008,3211,47,3211,47,0,105
방화중학교,25009,12,696,12,696,0,22
배다리,35186,11629,20034,11615,20034,14,1021
배다리삼거리,36006,14754,8070,14731,8070,23,736
배다리삼거리,36007,7143,11257,7108,11257,35,593
배다리청과물시장,35184,3967,2998,3938,2998,29,224
배다리헌책방거리,36158,567,652,567,652,0,39
배수지입구,42774,597,24,581,24,16,20
백두아파트,42632,9259,6766,9236,6766,23,516
백련사입구,43419,19,106,19,106,0,4
백련사입구,43808,110,7,106,7,4,3
백련산입구,35773,1,0,1,0,0,0
백련산입구,35778,1,20,1,20,0,0
백마장입구,40389,10621,2885,10619,2885,2,435
백마장입구,40390,2493,9889,2493,9889,0,399
백마장입구,40399,18809,19198,18799,19198,10,1226
백마장입구,40407,9643,9285,9637,9285,6,610
백병원(송림패션몰),36151,365,177,364,177,1,17
백사장회센터,62033,25,106,25,106,0,4
백사장회센터,62039,162,21,162,21,0,5
백산아파트,38112,3863,5046,3828,5046,35,287
백산아파트,38113,4696,4811,4685,4811,11,306
백산아파트,38328,1950,1640,1950,1640,0,115
백석고가(하이마트),42381,4999,4664,4998,4664,1,311
백석고가(하이마트),42578,4648,4027,4648,4027,0,279
백석마을,35096,42,57,42,57,0,3
백석중.고등학교,42374,7344,3786,7340,3786,4,359
백석중.고등학교,42375,4679,7250,4679,7250,0,384
백석중사거리,89238,1653,2327,1652,2327,1,128
백석중사거리,89239,224,5189,222,5189,2,174
백승아파트,41383,71,632,71,632,0,22
백승아파트,41384,122,246,122,246,0,11
백암왕순대앞,38483,2582,2187,2582,2187,0,153
백영아파트,40058,13508,4747,13503,4747,5,588
백영아파트,41361,8363,24,8363,24,0,270
백운곡,43040,222,111,220,111,2,10
백운곡,43295,162,250,161,250,1,13
백운공원,40072,6,619,6,619,0,20
백운공원(부평아트센터),40075,623,4095,623,4095,0,152
백운공원(부평아트센터),40076,2918,1406,2918,1406,0,139
백운역,40079,14254,22180,14245,22180,9,1175
백운역,40080,25208,19379,25198,19379,10,1438
백운역,40081,61122,54908,61122,54908,0,3742
백운역,40716,13716,3098,13716,3098,0,542
백운역(파출소),40094,89,1780,89,1780,0,60
백운역(하행),40901,3085,9743,3085,9743,0,413
백운프라자,37181,3823,10084,3817,10084,6,448
백운프라자,37185,7615,4305,7595,4305,20,384
백조아파트,40386,294,692,294,692,0,31
백조아파트,40388,1448,741,1448,741,0,70
뱃말항,44125,1,0,1,0,0,0
뱅뱅사거리,31012,6,1540,6,1540,0,49
뱅뱅사거리,32001,1808,24,1808,24,0,59
버드러지,43428,5,12,5,12,0,0
버드러지,43476,81,39,80,39,1,3
번영로제1사거리,39113,669,1549,669,1549,0,71
번영로제3사거리,39036,838,357,838,357,0,38
번영로제3사거리,39037,250,1298,250,1298,0,49
벌말,43175,1,45,1,45,0,1
벌말,43297,52,1,51,1,1,1
벌판마을입구,35763,17,185,17,185,0,6
벌판마을입구,35764,182,136,182,136,0,10
범양상가,42118,4233,9673,4233,9673,0,448
범양상가,42122,8717,2414,8711,2414,6,359
범양아파트,42116,8301,2688,8269,2688,32,354
범양아파트(종점),42127,123,7,123,7,0,4
범허리 종점,43973,3,0,3,0,0,0
범허리종점,43974,64,28,60,28,4,2
법원,37130,319,2100,319,2100,0,78
법원,37131,1910,1077,1910,1077,0,96
법원.검찰청,37074,8233,6012,8219,6012,14,459
법원.검찰청.복사골문화센터.반달마을,55020,4280,2102,4278,2102,2,205
법원검찰청입구,37078,3697,4542,3697,4542,0,265
베어즈베스트골프장,89268,419,1108,419,1108,0,49
베어즈베스트골프장,89269,280,2753,280,2753,0,97
베어즈베스트청라GC,89046,50,138,50,138,0,6
베어즈베스트청라GC,89047,67,202,67,202,0,8
벧엘교회,39740,173,1270,173,1270,0,46
벽산.이삭아파트,39453,18965,24552,18954,24552,11,1403
벽산1차아파트,70023,134,1764,134,1764,0,61
벽산1차아파트,70024,2250,272,2250,272,0,81
벽산아파트,39459,1525,25,1521,25,4,50
벽산아파트,39549,22,3150,22,3150,0,102
벽산아파트(미추홀도서관),39273,12004,4350,12003,4350,1,527
벽산이삭아파트,39458,19601,12791,19599,12791,2,1044
별립산입구,43588,1,147,1,147,0,4
별립산입구,43778,54,3,52,3,2,1
병무청(학익풍림아이원),37013,26,13,26,13,0,1
병무청(학익풍림아이원),37671,10,1162,10,1162,0,37
병방사거리,41301,710,3399,709,3399,1,132
병방사거리,41303,6103,2335,6089,2335,14,272
병방초등학교,41302,474,973,474,973,0,46
병방초등학교,41304,1595,1337,1595,1337,0,94
병방초등학교(계양산전통시장),41299,15739,12424,15739,12424,0,908
보건소,43318,18,12,15,12,3,0
보건소,43626,0,70,0,70,0,2
보건환경연구원,35158,1961,1775,1961,1775,0,120
보라매역.동작세무서,19013,239,15,239,15,0,8
보람프라자앞,42442,29242,17365,29238,17365,4,1503
보릿고개,43517,44,432,42,432,2,15
보릿고개,43880,255,117,255,117,0,12
보무기,90165,12,35,12,35,0,1
보무기,90166,37,16,37,16,0,1
보문사,90206,1769,1418,1728,1418,41,102
보스턴힐,89461,229,978,229,978,0,38
보스턴힐,89462,696,684,696,684,0,44
보트비,89424,23,222,23,222,0,7
보트비,89425,68,74,68,74,0,4
보훈회관,39484,4318,7793,4316,7793,2,390
복사골문화센터.한아름마을,55026,1833,3408,1833,3408,0,169
복지회관,38079,2982,1362,2976,1362,6,140
복지회관,38080,1387,4292,1377,4292,10,183
본향교회,39164,12590,2795,12554,2795,36,496
볼보트럭남인천사업소,35814,991,1260,991,1260,0,72
봉골,43535,27,6,27,6,0,1
봉골,43673,8,46,8,46,0,1
봉성(오상2리),43261,0,93,0,93,0,3
봉성(오상2리),43377,116,3,109,3,7,3
봉소리마을회관,43000,43,14,43,14,0,1
봉소리마을회관,90001,29,27,29,27,0,1
봉수대로501번길,89506,556,25,556,25,0,18
봉수대로501번길,89507,1,318,1,318,0,10
봉수초등학교,42980,1657,1308,1653,1308,4,95
봉수초등학교,42981,27,1117,27,1117,0,36
부개1동행정복지센터,40191,2493,6240,2473,6240,20,281
부개1동행정복지센터,40193,6950,3965,6930,3965,20,352
부개2동행정복지센터,40323,3183,1026,3183,1026,0,135
부개2파출소,40317,765,516,765,516,0,41
부개2파출소,40318,3538,8977,3491,8977,47,403
부개2파출소,40329,4608,2145,4590,2145,18,217
부개2파출소,40764,65,184,65,184,0,8
부개3동행정복지센터,40494,1442,287,1442,287,0,55
부개3동행정복지센터입구,40486,243,1222,243,1222,0,47
부개6단지후문.웅진플레이,55021,33,1758,33,1758,0,57
부개고입구,40345,3153,5023,3139,5023,14,263
부개고입구,40783,5669,2571,5636,2571,33,265
부개농협,40199,392,1815,387,1815,5,71
부개농협,40201,2166,1027,2131,1027,35,103
부개사거리,40923,402,2046,396,2046,6,78
부개서초등학교,40243,5870,1577,5870,1577,0,240
부개성일아파트,40293,6927,3003,6920,3003,7,320
부개성일아파트,40301,5706,9553,5692,9553,14,492
부개여자고등학교,40421,3099,1550,3095,1550,4,149
부개여자고등학교,40422,2451,2784,2444,2784,7,168
부개여자고등학교,40423,7581,5828,7581,5828,0,432
부개여자고등학교,40428,3849,5704,3849,5704,0,308
부개역,40222,1176,4861,1176,4861,0,194
부개역,40223,7049,2971,7017,2971,32,323
부개역,40256,34301,18358,34207,18358,94,1698
부개우체국,40458,9347,7374,9344,7374,3,539
부개종합시장,40504,8585,3356,8568,3356,17,385
부개주공2단지,40772,548,763,546,763,2,42
부개주공3단지,40479,2774,1217,2773,1217,1,128
부개주공3단지정문,40460,295,761,295,761,0,34
부개주공3단지후문,40500,3609,6093,3603,6093,6,312
부개주공6단지,40442,3832,2384,3831,2384,1,200
부개주공6단지,40459,4013,4646,4013,4646,0,279
부개주공7단지,40385,8815,3621,8815,3621,0,401
부개주공7단지,40387,3929,6115,3929,6115,0,324
부광여자고등학교,40471,576,2554,576,2554,0,100
부광초등학교,40434,1537,4101,1533,4101,4,181
부광초등학교,40440,5952,1973,5925,1973,27,255
부근삼거리,43586,589,66,583,66,6,21
부근삼거리,43652,171,523,170,523,1,22
부근삼거리,90403,0,28,0,28,0,0
부근삼거리,90404,7,6,7,6,0,0
부대아래,90106,10,6,9,6,1,0
부대아래,90107,30,3,30,3,0,1
부대앞,18392,184,6,184,6,0,6
부대앞,18397,2,66,2,66,0,2
부대앞,38594,113,348,113,348,0,14
부대앞,41321,187,443,187,443,0,20
부대앞,41322,280,1167,280,1167,0,46
부대앞,41531,47,150,47,150,0,6
부대앞,41532,90,126,90,126,0,6
부대앞,42342,381,743,381,743,0,36
부대앞,42343,152,369,152,369,0,16
부대앞,43435,32,37,32,37,0,2
부대앞,43787,96,28,95,28,1,4
부동산입구,38278,3420,1935,3420,1935,0,172
부동산입구,38743,189,638,189,638,0,26
부명고.순천향대학병원,55036,1993,6047,1993,6047,0,259
부원여중·동아아파트,40202,5899,2329,5860,2329,39,265
부원여중·동아아파트,40208,1099,4742,1091,4742,8,188
부원중학교,40181,26653,16567,26597,16567,56,1394
부원중학교,40789,12628,30045,12609,30045,19,1376
부일여자중학교,40123,14978,2382,14968,2382,10,560
부천IC,57023,2385,2632,2385,2632,0,161
부천IC,57025,3954,2387,3954,2387,0,204
부천시청역1번출구,55061,2066,540,2066,540,0,84
부천시청역2번출구.현대백화점.이마트,55054,16928,8285,16926,8285,2,813
부천시청역3번출구.경기예고.현대백화점,55057,5962,8458,5962,8458,0,465
부천시청역4번출구.현대백화점.경기예고,55059,8432,5808,8432,5808,0,459
부천시청역5번출구,55060,725,3752,725,3752,0,144
부천실내체육관,55075,1024,2055,1024,2055,0,99
부천오정물류단지(중),57042,518,1096,518,1096,0,52
부천오정물류단지(중),57043,672,904,672,904,0,50
부천자동차검사소,57017,912,1382,912,1382,0,74
부천자동차검사소,57041,1030,1596,1030,1596,0,84
부천터미널소풍,55051,2891,8473,2891,8473,0,366
부천테크노파크1.2단지,57001,1366,2123,1366,2123,0,112
부천테크노파크1단지,57003,2128,2128,2128,2128,0,137
부평2동행정복지센터,40744,302,1171,302,1171,0,47
부평4동성당,40377,3628,2715,3628,2715,0,204
부평4동성당,40922,3609,2778,3609,2778,0,206
부평6동우체국,40186,1037,395,1027,395,10,46
부평6동행정복지센터,40906,6144,275,6125,275,19,207
부평LH1(2)단지,40160,6494,7997,6486,7997,8,467
부평LH1(2)단지,40161,5503,4562,5491,4562,12,324
부평SKVIEW해모로아파트,40282,1435,1325,1435,1325,0,89
부평SKVIEW해모로아파트,40285,1364,1111,1364,1111,0,79
부평감리교회,40148,1159,580,1159,580,0,56
부평경찰서,40468,47660,17847,47651,17847,9,2113
부평경찰서,40794,14767,40222,14765,40222,2,1773
부평구보건소,40372,6206,2090,6206,2090,0,267
부평구보건소,40373,2428,6887,2428,6887,0,300
부평구보건소,40858,2003,2204,2003,2204,0,135
부평구보건소,40890,2820,3988,2820,3988,0,219
부평구자활센터,40651,17344,2064,17344,2064,0,626
부평구자활센터,40658,427,10346,427,10346,0,347
부평구청,40462,35082,26803,35079,26803,3,1996
부평구청,40482,5759,4543,5759,4543,0,332
부평구청,40484,4478,4814,4478,4814,0,299
부평구청,40492,4822,17076,4817,17076,5,706
부평구청·부평세무서,40451,28363,36161,28353,36161,10,2081
부평구청역,40841,20644,5324,20634,5324,10,837
부평기적의도서관,40497,6080,4022,6072,4022,8,325
부평기적의도서관.삼부한신아파트,40490,3372,3394,3364,3394,8,218
부평남부역,40169,3579,5516,3579,5516,0,293
부평남부역입구,40170,6502,2737,6502,2737,0,298
부평남초등학교,40141,2679,2268,2679,2268,0,159
부평남초등학교앞,40136,2452,3144,2452,3144,0,180
부평농장,39772,143,836,143,836,0,31
부평농장사무소,39483,1219,2010,1219,2010,0,104
부평농장의원입구,39494,287,442,287,442,0,23
부평도서관,40082,4643,4364,4641,4364,2,290
부평도서관,40084,2815,5281,2813,5281,2,261
부평동중,40406,3178,3018,3178,3018,0,199
부평동중,55009,3503,2633,3503,2633,0,197
부평래미안아파트,40437,2819,3667,2819,3667,0,209
부평래미안아파트,40438,5617,2423,5617,2423,0,259
부평북초등학교,40656,1221,506,1221,506,0,55
부평북초등학교,40657,764,3074,764,3074,0,123
부평사거리,40073,2847,5949,2841,5949,6,283
부평사거리,40074,13044,8210,13036,8210,8,685
부평사거리,40887,1468,5938,1468,5938,0,238
부평삼거리,39489,11972,9558,11963,9558,9,694
부평삼거리역,39491,3791,1909,3791,1909,0,183
부평삼거리역,40066,10493,9497,10487,9497,6,644
부평샬레아파트(세일고등학교),40260,1442,8486,1442,8486,0,320
부평샬레아파트(세일고등학교),40263,5377,1977,5372,1977,5,237
부평서중,40092,643,802,643,802,0,46
부평서중,40095,435,683,435,683,0,36
부평시장,40262,57137,29183,57092,29183,45,2784
부평시장,40264,23111,37061,23095,37061,16,1941
부평시장,40265,13104,6869,13093,6869,11,644
부평시장,40283,17575,11271,17570,11271,5,930
부평시장,40290,10486,8733,10470,8733,16,619
부평시장(가구의거리),40295,27408,25261,27312,25261,96,1699
부평시장(가구의거리),40296,30778,10572,30719,10572,59,1333
부평시장(당약국),40303,1331,1319,1331,1319,0,85
부평시장(용갈비),40344,6543,496,6543,496,0,227
부평시장(한남프라자),40259,15595,10238,15554,10238,41,833
부평시장(한라비발디),40328,6621,2600,6556,2600,65,297
부평시장(한라비발디),40336,9841,16398,9832,16398,9,846
부평시장역,40361,18874,51258,18858,51258,16,2262
부평시장역(부평대로우체국),40368,35823,15065,35799,15065,24,1641
부평시장입구,40288,4982,8803,4962,8803,20,444
부평시장입구(2번출구),40309,8340,10798,8325,10798,15,617
부평아트센터,40078,2414,1164,2414,1164,0,115
부평아트센터,40709,1253,3683,1253,3683,0,159
부평여자고등학교,40365,3983,1257,3983,1257,0,169
부평여자고등학교,40410,5011,7482,5000,7482,11,403
부평여자고등학교,40793,7822,7974,7821,7974,1,509
부평여자중학교,40342,274,653,274,653,0,29
부평여자중학교,40726,458,475,458,475,0,30
부평역,40190,10198,45235,10188,45235,10,1788
부평역,40209,41979,35272,41926,35272,53,2491
부평역,40226,27085,18531,27085,18531,0,1471
부평역,40228,39832,37000,39817,37000,15,2478
부평역,40234,16435,40731,16434,40731,1,1844
부평역,40237,14759,5803,14759,5803,0,663
부평역,40239,8584,9239,8584,9239,0,574
부평역,40927,18013,17877,17943,17877,70,1157
부평역(12번출구),40781,35564,72831,35534,72831,30,3496
부평역(27번출구),40224,39984,7133,39878,7133,106,1519
부평역(CU편의점),40192,36536,3730,36513,3730,23,1298
부평역(대한극장),40196,15075,54934,15058,54934,17,2258
부평역(로터스프라자),40246,20602,26451,20580,26451,22,1517
부평역(북인천우체국),40197,50440,32754,50410,32754,30,2683
부평역사박물관,40597,305,577,305,577,0,28
부평역사박물관,40609,1002,219,1002,219,0,39
부평역사박물관,40798,530,141,530,141,0,21
부평역화성파크드림아파트,40804,981,3913,972,3913,9,157
부평역화성파크드림아파트,40805,5021,1403,5009,1403,12,207
부평우체국,40430,4012,5200,4012,5200,0,297
부평우체국,40432,6510,4485,6508,4485,2,354
부평우체국,40443,328,213,328,213,0,17
부평윤산부인과,40478,460,436,460,436,0,28
부평윤산부인과,40768,210,1693,210,1693,0,61
부평자이,40871,166,1065,166,1065,0,39
부평정수장,40647,1625,3287,1625,3287,0,158
부평제이타워3차지식산업센터,40644,3892,2567,3892,2567,0,208
부평중앙침례교회,40481,141,941,141,941,0,34
부평중학교,40402,4452,3816,4452,3816,0,266
부평중학교,40416,3479,4504,3479,4504,0,257
부평캐슬앤더샵퍼스트,40931,450,8552,450,8552,0,290
부평코오롱아파트106동,40404,881,955,881,955,0,59
부평코오롱하늘채아파트,40357,718,622,718,622,0,43
부평코오롱하늘채아파트,40360,1174,784,1174,784,0,63
부평테크노타워,40615,1484,1659,1482,1659,2,101
부평테크노타워,40616,2319,3464,2318,3464,1,186
부현동초등학교,41175,9774,4261,9750,4261,24,452
부흥로터리,40412,1558,2181,1558,2181,0,120
부흥오거리(부흥아파트),40392,5655,5685,5643,5685,12,365
부흥오거리(부흥아파트),40394,6657,4249,6634,4249,23,351
부흥오거리(소망병원),40374,5478,8881,5459,8881,19,463
부흥오거리(소망병원),40375,14154,9918,14149,9918,5,776
부흥초교,40302,8132,1682,8117,1682,15,316
부흥초등학교,40299,3602,8167,3578,8167,24,379
부흥초등학교,40304,12206,6272,12206,6272,0,596
부흥초등학교·굿케어요양병원,40878,4081,6026,4081,6026,0,326
북구도서관,40469,2926,3103,2926,3103,0,194
북동삼거리,62001,385,53,385,53,0,14
북동삼거리,62002,32,448,32,448,0,15
북변환승센터.구터미널,80080,589,77,589,77,0,21
북변환승센터.구터미널,80081,0,204,0,204,0,6
북성교회,43744,22,17,22,17,0,1
북성교회,43764,10,5,10,5,0,0
북성마을,43136,143,16,140,16,3,5
북성마을,43528,32,70,32,70,0,3
북인천여자중학교,41007,6714,5398,6704,5398,10,390
북인천여자중학교,41008,5826,7029,5816,7029,10,414
북인천여자중학교,41015,819,14803,817,14803,2,503
북인천여자중학교,41016,8214,266,8167,266,47,273
북항다목적부두,89208,56,1585,56,1585,0,52
북항다목적부두,89209,1550,95,1550,95,0,53
북항배후단지입구,89343,3,667,3,667,0,21
북항배후로입구,89414,1,62,1,62,0,2
북항사업소,89210,12,1304,12,1304,0,42
북항사업소,89211,989,33,989,33,0,32
북항입구,89304,345,1557,345,1557,0,61
북항입구,89305,1768,215,1761,215,7,63
분오리어판장,43406,60,21,59,21,1,2
분오리어판장,43495,1,77,1,77,0,2
분오저수지,43493,2,28,2,28,0,0
분오저수지,43509,31,4,30,4,1,1
불로대곡동행정복지센터,42497,1013,1192,1008,1192,5,71
불로대곡동행정복지센터,42498,1193,2374,1193,2374,0,115
불로중학교,42648,188,668,188,668,0,27
불로중학교,42652,429,709,429,709,0,36
불은면주민센터,43035,713,471,708,471,5,38
불은초등학교,43293,51,5,50,5,1,1
불은초등학교,43530,2,45,2,45,0,1
불은파출소,43036,574,965,569,965,5,49
붉은노리삼거리,44112,76,104,63,104,13,5
붉은노리삼거리,44173,7,2,6,2,1,0
뷰티풀파크관리공단,42805,76,1,76,1,0,2
뷰티풀파크관리공단,42806,0,43,0,43,0,1
뷰티풀파크버스공영차고지,42803,18,1289,15,1289,3,42
뷰티풀파크버스공영차고지,42804,2257,10,2235,10,22,73
브라운스톤.엠코타운아파트,40659,14334,18173,14334,18173,0,1048
블랙트리캠핑장,44124,7,32,7,32,0,1
블랙트리캠핑장,44174,11,0,11,0,0,0
블루오션골프클럽(앰코코리아),39879,7,1289,7,1289,0,41
비류마을,38261,2143,1989,2143,1989,0,133
비선삼거리,43113,0,4,0,4,0,0
비선삼거리,43114,17,5,17,5,0,0
비선삼거리,43547,220,325,217,325,3,17
비선삼거리,43596,210,136,208,136,2,11
비재고개,35420,270,73,270,73,0,11
비재고개,35421,76,299,76,299,0,12
비전교회,44200,10,22,10,22,0,1
비젼교회,40171,3340,2260,3336,2260,4,180
빈정공원,42571,2227,885,2227,885,0,100
빈정공원,42670,516,917,516,917,0,46
빈정내사거리,42327,1789,2970,1789,2970,0,153
빈정내사거리,42329,816,607,816,607,0,45
사랑마을벽산.선경.삼익아파트,55030,2102,1383,2102,1383,0,112
사리울삼거리,39128,3851,5784,3849,5784,2,310
사리울삼거리,39131,3973,2639,3966,2639,7,213
사리울중학교,39838,1670,4985,1670,4985,0,214
사리울중학교,39924,6271,1549,6269,1549,2,252
사리울초등학교후문,39713,4795,707,4792,707,3,177
사슴농장,43531,88,0,79,0,9,2
사슴농장,43866,0,40,0,40,0,1
사시미재,35731,66,6,64,6,2,2
사시미재,35732,6,83,6,83,0,2
사업.행정지원센터,35607,664,11,664,11,0,21
사업.행정지원센터,35608,21,679,21,679,0,22
사우고.김포고(걸포사거리방면),80064,1,1051,1,1051,0,33
사우고.김포시청,80024,194,2392,194,2392,0,83
사우고교.김포시청(직행),80377,1023,163,1023,163,0,38
사우역.김포고,35246,3330,734,3330,734,0,131
사우역.김포고(김포초교방면),80380,1473,2721,1473,2721,0,135
사원아파트입구,42777,77,62,77,62,0,4
사일로벽화,35163,34,2762,34,2762,0,90
사일로벽화,35167,1249,153,1249,153,0,45
사정,90426,10,11,10,11,0,0
사조해표,42019,1546,2020,1542,2020,4,115
사조해표,42020,781,1651,781,1651,0,78
사직(해나무),43416,12,97,12,97,0,3
사직(해나무),43797,99,7,98,7,1,3
사촌,43597,108,3,104,3,4,3
사촌,43785,0,27,0,27,0,0
삭은다리한국지엠,40524,206,2748,205,2748,1,95
삭은다리한국지엠,40525,3598,1960,3594,1960,4,179
산곡3동행정복지센터,40156,3190,553,3190,553,0,120
산곡교회,40383,8362,3073,8313,3073,49,368
산곡남초등학교,40227,1264,74,1264,74,0,43
산곡동입구(롯데마트),40779,154,1713,153,1713,1,60
산곡동입구(롯데마트),40785,12749,21206,12736,21206,13,1095
산곡동주안빌딩,40313,13594,2386,13561,2386,33,515
산곡동천주교회,40473,30272,15936,30245,15936,27,1490
산곡동천주교회,40476,11574,32281,11546,32281,28,1414
산곡여자중학교,40198,7764,8050,7764,8050,0,510
산곡여자중학교,40203,2748,4955,2748,4955,0,248
산곡여자중학교,40215,38,1581,38,1581,0,52
산곡여자중학교,40216,4597,129,4597,129,0,152
산곡여자중학교(마장로삼거리),40911,950,1548,944,1548,6,80
산곡역(1번출구),40420,5654,26131,5651,26131,3,1025
산곡역(3번출구),40856,11407,5427,11399,5427,8,543
산곡역(6번출구),40429,7615,24155,7600,24155,15,1024
산곡역(7번출구),40425,61365,36119,61354,36119,11,3144
산곡중학교,40320,558,112,558,112,0,21
산곡중학교,40322,150,1156,150,1156,0,42
산곡한양7차,40354,124,9994,118,9994,6,326
산뒤,43235,32,115,29,115,3,4
산뒤,43887,102,14,97,14,5,3
산림조합앞,90234,38,45,36,45,2,2
산림조합앞,90235,38,143,38,143,0,5
산마루집,41497,15,36,15,36,0,1
산마루집,41513,26,0,26,0,0,0
산마을고등학교,43116,0,8,0,8,0,0
산마을고등학교,43599,20,4,20,4,0,0
산문입구,43107,106,174,106,174,0,9
산문입구,43286,214,168,209,168,5,12
산문입구,43899,13,1,12,1,1,0
산문종점,43154,57,132,57,132,0,6
산애들애,43143,2,13,2,13,0,0
산애들애,43492,1,3,1,3,0,0
산업단지사거리,36095,62,4146,62,4146,0,135
산업단지사거리,37460,5914,231,5911,231,3,198
산업용품센타,42524,5626,455,5620,455,6,196
산업용품센타,42525,22,2685,21,2685,1,87
산업용품유통센타23동,36096,312,1915,312,1915,0,71
산업용품유통센타31동,36097,163,1813,163,1813,0,63
산업용품유통센타39동,36099,249,1977,249,1977,0,71
산업용품유통센터,36156,555,83,555,83,0,20
산업용품유통센터1동,36146,2131,357,2131,357,0,80
산업용품유통센터39동,36157,30,12,26,12,4,1
산업용품유통센터C동,36101,1945,15,1945,15,0,63
산우리고개,43337,3,21,3,21,0,0
산우리고개,43850,30,9,30,9,0,1
산음입구,80004,8,440,8,440,0,14
산음입구,80005,126,12,123,12,3,4
산촌마을,43217,2,3,2,3,0,0
산촌마을,43308,17,17,17,17,0,1
산호아파트앞,80059,1370,146,1370,146,0,48
산화고개,43271,161,37,155,37,6,6
산화고개,43388,40,212,37,212,3,8
삼덕아파트,37403,677,813,677,813,0,48
삼덕아파트,37404,574,931,574,931,0,48
삼동암리마을회관,43169,4,29,4,29,0,1
삼동암리마을회관,43227,56,2,56,2,0,1
삼두2차아파트,36051,4356,910,4320,910,36,169
삼라마이다스아파트,89317,200,5,198,5,2,6
삼라마이다스아파트,89323,3,116,2,116,1,3
삼목사거리,35088,4,33,4,33,0,1
삼목선착장,35311,333,999,333,999,0,42
삼목선착장(운서역행),35077,1975,503,1975,503,0,79
삼목선착장입구,35058,1,30,1,30,0,1
삼목선착장입구,35059,3,3,3,3,0,0
삼목초등학교,35310,1870,1738,1870,1738,0,116
삼목초등학교,35341,2953,2212,2952,2212,1,166
삼미시장,25915,3196,566,3196,566,0,121
삼미시장,70172,549,3325,549,3325,0,124
삼미타운.e편한세상아파트,40172,4984,5461,4977,5461,7,336
삼보새마을금고,40796,9327,767,9327,767,0,325
삼보아파트,40298,2726,133,2726,133,0,92
삼보아파트,40308,12672,4362,12659,4362,13,549
삼보아파트,40677,7964,464,7964,464,0,271
삼보아파트,40679,462,7093,462,7093,0,243
삼보아파트,40786,5403,19440,5398,19440,5,801
삼보아파트,42350,2656,6191,2656,6191,0,285
삼보아파트,42351,6943,1951,6943,1951,0,286
삼보아파트(계양구청),41205,4697,8681,4692,8681,5,431
삼산경찰서,40584,1255,3199,1255,3199,0,143
삼산경찰서,40766,1732,2907,1732,2907,0,149
삼산고등학교(미래타운3단지),40689,12195,2352,12195,2352,0,469
삼산고등학교(미래타운4단지),40686,5019,9956,5019,9956,0,483
삼산군립어린이집,90171,8,16,8,16,0,0
삼산군립어린이집,90172,16,11,16,11,0,0
삼산글로리병원,40527,8250,6570,8234,6570,16,478
삼산농산물시장,40687,1684,4716,1684,4716,0,206
삼산동차고지,40830,214,9,214,9,0,7
삼산면사무소,90149,32,61,30,61,2,3
삼산면사무소,90150,124,74,120,74,4,6
삼산사거리,40638,5945,11057,5945,11057,0,548
삼산사거리,40690,3094,731,3094,731,0,123
삼산사거리,40691,7784,4469,7784,4469,0,395
삼산사거리,40924,323,2252,323,2252,0,83
삼산사거리(한국아파트),40646,3995,13352,3995,13352,0,559
삼산사거리.한국아파트,40645,6239,1919,6239,1919,0,263
삼산새마을금고,40668,629,9062,629,9062,0,312
삼산서해그랑블,40589,1494,2287,1494,2287,0,121
삼산서해아파트,40613,2591,818,2591,818,0,109
삼산월드체육관,40532,8655,2822,8652,2822,3,370
삼산월드체육관,40535,1594,1276,1593,1276,1,92
삼산월드체육관,40543,69,4815,69,4815,0,157
삼산월드체육관,40571,1715,2323,1715,2323,0,130
삼산월드체육관(삼산주공6단지),40802,868,1959,868,1959,0,91
삼산저수지앞,90245,2,2,2,2,0,0
삼산주공1단지,40780,1831,41,1831,41,0,60
삼산주공1단지(상가앞),40908,7231,445,7231,445,0,247
삼산주공4단지,40591,818,1913,818,1913,0,88
삼산주공7단지,40547,7056,7466,7056,7466,0,468
삼산주공7단지,40801,7852,7896,7852,7896,0,508
삼산중학교,40636,1451,792,1451,792,0,72
삼산중학교,40637,1009,1288,1009,1288,0,74
삼산체육관역(호수공원),40536,10793,3619,10793,3619,0,464
삼산체육관역(호수공원),40539,580,6496,580,6496,0,228
삼산체육관역.상동호수공원,55040,418,3474,416,3474,2,125
삼산체육관역.상동호수공원,55041,356,679,356,679,0,33
삼산체육관역.영상문화단지정문,55044,12889,4083,12889,4083,0,547
삼산타운1단지,40588,4794,7637,4794,7637,0,401
삼산타운1단지정문,40585,3123,1386,3123,1386,0,145
삼산타운1단지후문,40611,1432,689,1432,689,0,68
삼산타운1단지후문,40612,558,882,558,882,0,46
삼산타운4단지,40608,2266,587,2266,587,0,92
삼산타운6단지,40580,2436,2364,2436,2364,0,154
삼산타운7단지,40576,2235,2778,2235,2778,0,161
삼산푸른솔마을,40653,34,2558,34,2558,0,83
삼선1리마을회관,90263,1,9,1,9,0,0
삼선1리마을회관,90280,6,0,6,0,0,0
삼선1리삼거리,90262,0,10,0,10,0,0
삼선1리삼거리,90281,8,1,8,1,0,0
삼선2리마을회관,90265,2,31,2,31,0,1
삼선2리마을회관,90278,30,3,30,3,0,1
삼선2리입구,90264,1,5,1,5,0,0
삼선2리입구,90279,5,0,5,0,0,0
삼성바이오로직스,39863,9,1054,9,1054,0,34
삼성바이오로직스,39864,5741,43,5741,43,0,186
삼성바이오로직스,39920,1801,2540,1801,2540,0,140
삼성빌라(종점),37572,595,910,595,910,0,48
삼성서초역삼세무서,23396,949,1143,949,1143,0,67
삼성아파트,35140,2517,5331,2506,5331,11,253
삼성아파트,38077,5414,5849,5414,5849,0,363
삼성아파트.남인천농협,38125,5879,8042,5879,8042,0,449
삼양감속기,39085,0,7,0,7,0,0
삼양베이커,35131,10,138,10,138,0,4
삼양베이커,35571,74,10,74,10,0,2
삼양사인천1공장,42027,1154,1431,1149,1431,5,83
삼양사인천1공장,42031,2675,4011,2672,4011,3,215
삼영물류,42068,7461,592,7461,592,0,259
삼영아파트,37116,6857,2396,6836,2396,21,298
삼영아파트,37279,10480,12089,10470,12089,10,728
삼영아파트,37280,8258,5183,8250,5183,8,433
삼영아파트,42085,12292,6612,12251,6612,41,609
삼영테크,89055,1843,195,1839,195,4,65
삼영테크,89062,10,1631,10,1631,0,52
삼원페트라,39041,415,3660,415,3660,0,131
삼은교회,37111,4962,1734,4947,1734,15,216
삼익.광명아파트,39247,10338,14209,10327,14209,11,791
삼익.광명아파트,39249,17700,8401,17692,8401,8,841
삼익아파트,35136,2811,7144,2785,7144,26,321
삼익아파트.달동네박물관,36017,9409,11415,9388,11415,21,671
삼일산업,39097,2363,2103,2363,2103,0,144
삼정동중소기업협동화단지,57015,821,999,821,999,0,58
삼정동중소기업협동화단지,57040,1021,703,1021,703,0,55
삼정사거리,57011,668,974,668,974,0,52
삼정사거리,57012,885,539,884,539,1,45
삼정초등학교,57008,1123,864,1123,864,0,64
삼정초등학교,57009,460,931,460,931,0,44
삼정프라자,42443,18558,25287,18552,25287,6,1414
삼진금속,39040,2743,330,2743,330,0,99
삼천리1차아파트,41178,2994,2771,2986,2771,8,185
삼천리1차아파트,41179,2986,2356,2957,2356,29,172
삼천리3차아파트,41150,5748,4416,5709,4416,39,327
삼천리3차아파트,41159,5119,5502,5091,5502,28,342
삼천리기계,92017,139,472,139,472,0,19
삼천리기계,92018,199,209,199,209,0,13
삼호제강2공장,39939,151,852,151,852,0,32
삼호제강2공장,39940,702,184,702,184,0,28
삼환1단지아파트,37252,1559,2764,1559,2764,0,139
삼환아파트,38063,1820,2704,1817,2704,3,145
삼환아파트,39296,220,1576,220,1576,0,57
삼환아파트,39299,3928,2304,3925,2304,3,201
삼환아파트,39316,12095,8803,12095,8803,0,674
삼환아파트,39323,1025,3948,1025,3948,0,160
삼환아파트,39328,8234,7745,8234,7745,0,515
삼환아파트,80058,31,1767,31,1767,0,58
상1리마을회관(창말),90339,0,15,0,15,0,0
상1리마을회관(창말),90342,14,0,9,0,5,0
상2리마을회관,90337,2,11,2,11,0,0
상2리마을회관,90343,30,0,30,0,0,0
상덕현삼거리,43462,8,19,8,19,0,0
상덕현삼거리,43767,3,23,3,23,0,0
상도중학교,55025,1731,107,1731,107,0,59
상도중학교,55028,489,1741,489,1741,0,71
상동가구,55090,1916,1505,1912,1505,4,110
상동역1번출구.부천터미널소풍.홈플러스,55052,7440,21878,7440,21878,0,945
상동역4번출구.상동지하차도,55048,1624,5844,1624,5844,0,240
상동역5번출구.상동지하차도,55050,16394,3159,16385,3159,9,630
상동역8번출구세이브존,55056,10626,5571,10623,5571,3,522
상사마을,25027,91,221,91,221,0,10
상수도사업본부(스마트타운),37375,5405,7992,5395,7992,10,432
상수도사업본부(스마트타운),37380,5592,11691,5567,11691,25,557
상야동,41436,1299,1134,1299,1134,0,78
상야동,41437,1114,1473,1114,1473,0,83
상용리마을회관,90038,0,32,0,32,0,1
상용리마을회관,90039,52,0,51,0,1,1
상용진료소앞,90004,15,68,14,68,1,2
상용진료소앞,90005,43,14,40,14,3,1
상인천중학교,39537,223,136,222,136,1,11
상인천초등학교,39340,916,465,896,465,20,44
상인천초등학교,39345,372,1034,369,1034,3,45
상정고,40069,14469,3376,14463,3376,6,575
상정고,40070,4347,16817,4344,16817,3,682
상정중학교,40059,4699,8275,4689,8275,10,418
상주(상리),90331,1,0,1,0,0,0
상주민지원센터.삼광교회,55029,1277,4162,1275,4162,2,175
상주민지원센터.삼광교회,55031,5644,585,5643,585,1,200
상촌,43152,39,14,39,14,0,1
상촌,43347,36,48,36,48,0,2
새꾸지마을,90133,26,19,25,19,1,1
새꾸지마을,90134,39,40,39,40,0,2
새마을,43471,0,9,0,9,0,0
새마을,43702,7,0,7,0,0,0
새마을금고,36053,2540,999,2523,999,17,114
새마을금고,36189,356,1667,353,1667,3,65
새마을금고,40125,907,1310,904,1310,3,71
새마을금고,40126,1907,268,1907,268,0,70
새마을금고,40131,1123,3704,1123,3704,0,155
새마을금고,40746,81,857,81,857,0,30
새말사거리,41009,4163,2305,4163,2305,0,208
새말사거리,41010,99,3181,99,3181,0,105
새말사거리,41012,1418,3089,1409,3089,9,145
새말사거리,41013,3239,2671,3235,2671,4,190
새말사거리,41638,888,1941,888,1941,0,91
새봄초등학교,38679,2558,4907,2558,4907,0,240
새봄초등학교·송도파크레인(후문),38678,5497,2074,5487,2074,10,244
새사미아파트,41582,480,344,480,344,0,26
새소망교회,40850,2136,12,2136,12,0,69
새소망교회,40917,6,442,6,442,0,14
새안의원,37255,10742,13325,10735,13325,7,776
새안의원,37256,18205,9147,18194,9147,11,882
새터마을,35033,18,265,18,265,0,9
새터마을,35362,295,43,295,43,0,10
새한아파트,37046,4777,2520,4767,2520,10,235
색동원 앞,43161,7,3,7,3,0,0
색동원 앞,43215,3,7,3,7,0,0
샘골,90406,0,5,0,5,0,0
샘골,90407,15,0,13,0,2,0
샘내들교,89518,98,428,98,428,0,16
샘내들교,89519,151,1003,147,1003,4,37
샘말,43444,3,25,3,25,0,0
샘말,43782,36,18,35,18,1,1
샛말,43994,23,14,23,14,0,1
샛말,43995,10,32,10,32,0,1
생산기술연구원,38354,287,1188,287,1188,0,47
생설미,43746,472,313,455,313,17,25
생설미입구,43125,10,12,10,12,0,0
생설미입구,43607,42,14,41,14,1,1
생설미입구,43608,0,70,0,70,0,2
샬롬원입구,90293,3,18,3,18,0,0
샬롬원입구,90297,3,0,3,0,0,0
서곶지구대,42338,10979,7664,10979,7664,0,601
서곶지구대,42339,10288,8675,10288,8675,0,611
서교동,23037,215,4358,215,4358,0,147
서교동,23038,11909,292,11909,292,0,393
서구국민체육센터,42776,682,3491,680,3491,2,134
서구문화회관,42212,1524,2009,1517,2009,7,113
서구문화회관,42213,3226,849,3195,849,31,131
서구보건소,42283,4886,3867,4886,3867,0,282
서구보건소,42285,3717,4509,3717,4509,0,265
서구영어마을,42448,7387,6287,7387,6287,0,441
서구영어마을,42449,5093,8412,5092,8412,1,435
서구청역(1번출구),42289,4402,4230,4402,4230,0,278
서구청역(3번출구),42284,1546,803,1541,803,5,75
서구청역(4번출구),42296,2256,2465,2249,2465,7,152
서남촌,43151,8,4,8,4,0,0
서남촌,43640,1,10,1,10,0,0
서당골,35676,47,49,47,49,0,3
서당골,35702,73,57,73,57,0,4
서두머리,43212,38,0,37,0,1,1
서두머리,43336,0,17,0,17,0,0
서림초등학교,36036,3,854,3,854,0,27
서림초등학교,36047,15133,1569,15133,1569,0,538
서릿목,35418,140,553,140,553,0,22
서릿목,35419,520,113,520,113,0,20
서면초등학교,38384,1936,1493,1932,1493,4,110
서문안,43385,21,123,21,123,0,4
서문안,43584,197,17,181,17,16,6
서문안주유소,43965,119,2,114,2,5,3
서문안주유소,43966,16,200,16,200,0,6
서부경찰서,42286,520,816,520,816,0,43
서부공단입구,42299,5005,4572,5005,4572,0,308
서부공단입구,42301,6655,1477,6655,1477,0,262
서부산업단지,89035,60,60,60,60,0,3
서부산업단지,89036,41,273,41,273,0,10
서사체험학습장,43487,14,9,14,9,0,0
서사체험학습장,43712,8,6,8,6,0,0
서성,43234,9,100,9,100,0,3
서성,43362,209,12,207,12,2,7
서운교,41114,808,4653,808,4653,0,176
서운교,41115,4179,387,4179,387,0,147
서운도서관,41099,1742,276,1742,276,0,65
서운도서관,41102,225,2050,225,2050,0,73
서운도서관,41668,76,2328,76,2328,0,77
서운동,41356,6752,667,6738,667,14,239
서운동성당,41207,1592,1997,1592,1997,0,115
서운일반산업단지,41660,2196,37,2170,37,26,72
서운일반산업단지(맞은편),41661,35,1625,31,1625,4,53
서운일반산업단지입구,41646,575,3636,575,3636,0,135
서운일반산업단지입구(맞은편),41647,1139,1234,1139,1234,0,76
서운중고등학교,41109,294,598,294,598,0,28
서운중고등학교,41111,827,555,827,555,0,44
서울경금속,39039,246,2843,246,2843,0,99
서울방화초등학교,25028,58,16,58,16,0,2
서울역,11013,16179,12340,16179,12340,0,919
서원아파트,37095,1581,1269,1580,1269,1,91
서인천가구단지,42017,1013,3265,1013,3265,0,138
서인천가구단지,42028,3513,2852,3504,2852,9,205
서인천가구단지,42800,723,86,723,86,0,26
서인천고등학교,42346,3957,4671,3957,4671,0,278
서인천농협,42275,1549,452,1547,452,2,64
서인천농협,42277,226,935,226,935,0,37
서인천세무서,89044,300,69,300,69,0,11
서인천세무서,89481,183,87,183,87,0,8
서인천세무서(중),89275,2118,2773,2118,2773,0,157
서인천세무서(중),89276,1289,2352,1289,2352,0,117
서인천자동차검사소,42640,470,3020,470,3020,0,112
서인천자동차검사소,42641,3999,320,3999,320,0,139
서창119안전센터,39900,11680,3578,11680,3578,0,492
서창119안전센터,39899,5836,10913,5836,10913,0,540
서창LH1단지아파트,92067,5598,443,5598,443,0,194
서창LH1단지아파트,92068,988,4344,988,4344,0,172
서창공영차고지,39871,8302,110,8302,110,0,271
서창공영차고지,39872,1623,5979,1622,5979,1,245
서창도서관,39893,1151,1787,1151,1787,0,94
서창도서관,39894,2027,1166,2027,1166,0,103
서창도서관입구,39956,163,1600,163,1600,0,56
서창도서관입구,39957,2769,763,2769,763,0,113
서창동화원,39619,191,909,191,909,0,35
서창동화원,39620,608,365,608,365,0,31
서창베라체아파트후문,39895,378,109,378,109,0,15
서창베라체아파트후문,39896,23,501,23,501,0,16
서창센트라스아파트후문,39916,6748,758,6748,758,0,242
서창센트라스아파트후문,39917,1213,4020,1213,4020,0,168
서창센트럴푸르지오,39811,3441,325,3441,325,0,121
서창센트럴푸르지오,39812,370,3270,370,3270,0,117
서창센트럴푸르지오,39903,13974,7993,13974,7993,0,708
서창센트럴푸르지오,39904,13516,12717,13516,12717,0,846
서창이편한세상1002동,39905,12966,8459,12966,8459,0,691
서창이편한세상1002동,39906,7931,13968,7931,13968,0,706
서창이편한세상정문,39854,735,13609,735,13609,0,462
서창이편한세상정문,39855,14804,504,14804,504,0,493
서창퍼스트뷰후문,39777,12621,3153,12621,3153,0,508
서창퍼스트뷰후문맞은편,39778,1976,11048,1976,11048,0,420
서창휴먼시아12단지,39897,2429,151,2429,151,0,83
서창휴먼시아12단지,39898,374,1820,374,1820,0,70
서초구청,22129,464,47,464,47,0,16
서초동삼성아파트,22140,21,153,21,153,0,5
서초아트자이아파트,31050,4590,12118,4590,12118,0,538
서초역1번출구,31007,9903,24458,9903,24458,0,1108
서초힐스아파트,22286,604,1725,604,1725,0,75
서한리구마을회관,90294,12,13,12,13,0,0
서한리구마을회관,90296,9,3,9,3,0,0
서한리마을회관,90295,35,33,35,33,0,2
서한리입구,90292,0,1,0,1,0,0
서한리입구,90298,2,0,2,0,0,0
서해5도특별경비단,35098,1321,142,1309,142,12,47
서해5도특별경비단,35884,15,1277,14,1277,1,41
서해그랑블,40828,2244,144,2244,144,0,77
서해그랑블,42789,3516,7974,3516,7974,0,370
서해그랑블,42790,6076,2514,6076,2514,0,277
서해그랑블,42912,4119,843,4117,843,2,160
서해그랑블1단지아파트,38604,1195,34,1195,34,0,39
서해그랑블1단지아파트,38605,40,701,40,701,0,23
서해그랑블3단지아파트,38725,767,31,767,31,0,25
서해그랑블3단지아파트,38726,27,644,27,644,0,21
서해그랑블아파트후문,39973,2117,2434,2117,2434,0,146
서해그랑블아파트후문,39974,3220,2925,3220,2925,0,198
서해그랑블후문,40610,116,1106,116,1106,0,39
서해수산연구소,35007,106,23,106,23,0,4
서해수산연구소,35008,22,249,22,249,0,8
서해아파트,38164,3253,1729,3253,1729,0,160
서해아파트,38169,2587,2519,2587,2519,0,164
서해아파트,41181,1660,2292,1660,2292,0,127
서해아파트,41182,2841,1382,2841,1382,0,136
서해아파트,42354,4025,9714,4025,9714,0,443
서해아파트,42355,16867,3790,16867,3790,0,666
서홍의입구,43446,2,11,2,11,0,0
서홍의입구,43796,46,5,44,5,2,1
서화초등학교(도화e편한세상),37438,15468,7763,15433,7763,35,749
서화초등학교(도화e편한세상),37623,10350,12133,10333,12133,17,725
서흥초등학교,36071,7564,3314,7541,3314,23,350
서흥초등학교,36116,646,440,646,440,0,35
서흥초등학교,36117,290,2255,289,2255,1,82
석건연립,37051,2082,8154,2082,8154,0,330
석남고가교입구사거리,42655,23336,9040,23336,9040,0,1044
석남고가사거리,42145,21334,17813,21289,17813,45,1262
석남고가사거리,42151,30375,21795,30352,21795,23,1682
석남금호어울림아파트101동,42656,4564,9068,4564,9068,0,439
석남도서관,42182,832,2292,832,2292,0,100
석남서초등학교,42108,5223,3016,5220,3016,3,265
석남신사거리,42149,2152,1571,2150,1571,2,120
석남신사거리,42150,2079,2864,2072,2864,7,159
석남역(5번출구),42577,21632,45797,21630,45797,2,2175
석남중앙교회,42138,3009,1880,2996,1880,13,157
석남중학교,42126,7270,5865,7251,5865,19,423
석남중학교,42128,6730,6695,6703,6695,27,433
석남초등학교,42165,10784,3248,10700,3248,84,452
석남초등학교,42167,3073,8638,3064,8638,9,377
석락아파트,37241,11211,9045,11203,9045,8,653
석락아파트,37244,2115,3956,2115,3956,0,195
석모1리마을회관,90145,62,17,62,17,0,2
석모1리마을회관,90146,7,34,7,34,0,1
석모대교(석모리방향),90137,0,24,0,24,0,0
석모대교(석모리방향),90138,30,10,30,10,0,1
석모대교(석포리방향),90139,22,0,22,0,0,0
석모대교(석포리방향),90140,13,61,12,61,1,2
석모대교(외포리방향),90121,4,51,4,51,0,1
석모대교(외포리방향),90122,35,9,34,9,1,1
석모대교전망대,90249,0,3,0,3,0,0
석모대교전망대,90250,2,7,2,7,0,0
석모도미네랄온천,90163,76,34,76,34,0,3
석모도미네랄온천,90164,5,56,5,56,0,1
석모도수목원입구(삼산초등학교),90143,11,68,11,68,0,2
석모도수목원입구(삼산초등학교),90144,100,39,98,39,2,4
석모도자연휴양림입구,90151,4,5,4,5,0,0
석모도자연휴양림입구,90152,12,17,12,17,0,0
석바위,37365,23276,20130,23238,20130,38,1400
석바위,37370,54679,41142,54645,41142,34,3091
석바위시장,37378,2327,6763,2318,6763,9,293
석바위시장,37381,24115,25171,24081,25171,34,1589
석바위시장,37382,22898,20355,22874,20355,24,1395
석바위시장,37384,5271,3970,5263,3970,8,298
석바위시장,37544,3154,4290,3141,4290,13,240
석바위시장역,37373,4830,5622,4809,5622,21,337
석바위시장역,37374,4178,4924,4170,4924,8,293
석산,43375,0,41,0,41,0,1
석산,43833,31,1,30,1,1,1
석산로,92051,961,421,955,421,6,44
석산로,92052,430,555,425,555,5,31
석암초등학교,37412,4295,4300,4290,4300,5,277
석암초등학교앞,37407,15132,9225,15101,9225,31,785
석정여자고등학교,39416,1701,288,1701,288,0,64
석정여자고등학교,39418,154,1946,154,1946,0,67
석조여래입상앞,43663,0,22,0,22,0,0
석조여래입상앞,43692,70,1,70,1,0,2
석천사거리,39308,682,834,682,834,0,48
석천사거리역,39317,4126,7259,4123,7259,3,367
석천사거리역,39320,3081,3381,3065,3381,16,208
석천시장,39502,752,4413,752,4413,0,166
석포리마을회관,90191,32,6,32,6,0,1
석포리마을회관,90192,3,35,3,35,0,1
석포항,90203,14,61,14,61,0,2
선경그린빌라,42307,2361,1600,2361,1600,0,127
선경그린빌라,42541,117,851,117,851,0,31
선경아파트,40238,7113,1887,7113,1887,0,290
선광,38542,1,275,1,275,0,8
선광,38543,205,12,205,12,0,7
선녀바위유원지,35004,864,40,864,40,0,29
선녀바위유원지,35006,239,852,239,852,0,35
선녀바위해수욕장,35484,1408,246,1408,246,0,53
선녀바위해수욕장,35485,322,1357,321,1357,1,54
선동,43248,1,25,1,25,0,0
선동,43886,71,4,71,4,0,2
선두1리,43009,293,105,293,105,0,12
선두1리,43099,46,202,40,202,6,8
선두4리마을회관,43242,21,1,21,1,0,0
선두4리마을회관,43644,9,29,9,29,0,1
선두5리어판장입구,90131,4,39,4,39,0,1
선두5리어판장입구,90132,28,3,28,3,0,1
선릉역,23218,2984,4,2984,4,0,96
선릉역,23259,26,4599,26,4599,0,149
선린감리교회,40043,3712,2082,3708,2082,4,186
선린감리교회,40047,4612,6311,4609,6311,3,352
선바위역,66002,1121,38499,1121,38499,0,1278
선바위역2번출구(광역),66001,21480,770,21480,770,0,717
선수,43433,0,6,0,6,0,0
선수,43483,28,7,28,7,0,1
선수여객선착장,43429,210,195,192,195,18,13
선수여객선착장,43479,8,41,8,41,0,1
선수촌사거리,39889,201,700,201,700,0,29
선수촌사거리,39890,335,394,335,394,0,23
선원면사무소앞,90067,1,31,1,31,0,1
선원면사무소앞,90068,10,6,10,6,0,0
선원면주민센터,43042,190,415,189,415,1,19
선원면주민센터,43070,502,167,493,167,9,21
선원사,43305,0,1,0,1,0,0
선원사,43742,19,14,19,14,0,1
선원사초입,43307,11,5,9,5,2,0
선원사초입,43756,4,3,4,3,0,0
선원초등학교,43044,60,197,60,197,0,8
선원초등학교,43045,214,66,211,66,3,9
선유고등학교,28017,11298,718,11298,718,0,387
선유고등학교,28018,760,12675,760,12675,0,433
선재대교,44085,9,0,9,0,0,0
선재대교,44175,1,4,1,4,0,0
선재대교입구,44005,36,497,36,497,0,17
선재대교입구,44006,554,41,554,41,0,19
선재바다낚시터,44146,2,0,2,0,0,0
선주삼거리,41481,15,76,15,76,0,2
선주지교회,41482,23,42,23,42,0,2
선주지교회,41503,5,1,5,1,0,0
선주지다리,41480,4,56,4,56,0,1
선주지다리,41501,2,5,2,5,0,0
선주지회차지,41483,19,53,19,53,0,2
선학동행정복지센터.정광아파트,38297,1386,1262,1383,1262,3,85
선학사거리,38295,1334,4075,1333,4075,1,174
선학아파트,38232,6246,1727,6246,1727,0,257
선학아파트,38343,3478,10511,3470,10511,8,451
선학어린이집,38300,2072,1965,2031,1965,41,130
선학역,38305,32935,15247,32926,15247,9,1554
선학역(1번출구),38306,20331,25312,20306,25312,25,1472
선학중학교,38283,967,906,955,906,12,60
선학체육관(하키경기장),38308,3155,1980,3145,1980,10,165
선학체육관(하키경기장),38309,2715,4350,2712,4350,3,227
선행리입구,43908,44,108,44,108,0,4
선행리입구,43909,43,0,42,0,1,1
설호아파트,43378,19,78,19,78,0,3
설호아파트,43618,171,47,165,47,6,7
성강지식산업센터,39837,576,731,576,731,0,42
성경,43603,144,15,144,15,0,5
성경,43771,25,135,25,135,0,5
성리중학교,39969,22,21,22,21,0,1
성리중학교,39979,1,196,1,196,0,6
성리초등학교,39200,21125,20320,21082,20320,43,1336
성리초등학교,39201,9746,16336,9730,16336,16,841
성문교회,39462,456,4,455,4,1,14
성문아파트,39591,4107,1567,4107,1567,0,183
성문아파트(문화연립),39257,3132,4193,3132,4193,0,236
성민병원,42159,15551,15138,15510,15138,41,989
성민병원,42162,14188,16875,14168,16875,20,1002
성보공업,42007,1886,2321,1879,2321,7,135
성산교회,40572,1076,6047,1076,6047,0,229
성신아크릴산업,89313,133,1,123,1,10,4
성신아크릴산업,89327,5,161,5,161,0,5
성웅아파트,42048,3793,2714,3790,2714,3,209
성웅아파트,42051,4069,2664,4063,2664,6,217
성원기계,92016,1606,1635,1606,1635,0,104
성원빌딩.우편취급국,37425,11281,6429,11281,6429,0,571
성원아파트,70022,2418,10,2418,10,0,78
성일산업,39787,1073,1477,1073,1477,0,82
성일산업,39788,1032,793,1032,793,0,58
성일아파트후문앞,40311,840,536,840,536,0,44
성지아파트,38017,24107,40751,24096,40751,11,2092
성지아파트,41025,5585,3851,5585,3851,0,304
성지초등학교,41033,2005,3561,1980,3561,25,179
성지초등학교,41034,2572,1718,2555,1718,17,138
성터지,43038,297,85,296,85,1,12
성터지,43039,69,252,69,252,0,10
성호아파트,38204,11735,11312,11735,11312,0,743
세광2차아파트,43758,2068,649,2043,649,25,87
세광2차아파트,43857,408,1588,402,1588,6,64
세광아파트,43049,1025,2136,1015,2136,10,101
세광아파트,43050,2545,789,2529,789,16,107
세농푸드,41510,27,0,27,0,0,0
세우산업,39094,1978,4327,1978,4327,0,203
세월천사거리,40489,2529,9136,2529,9136,0,376
세일빌라.인천산림조합,39158,2587,1201,2579,1201,8,122
세일빌라.인천산림조합,39159,4815,4025,4814,4025,1,285
세현정공,39033,1020,1877,1020,1877,0,93
세화파렛텍,90216,44,38,44,38,0,2
센타빌딩,39902,11776,13655,11776,13655,0,820
센트럴공원,38490,880,3131,880,3131,0,129
센트럴파크1,38463,600,121,600,121,0,23
센트럴파크2,38464,407,374,407,374,0,25
센트럴파크역,38397,8622,1411,8622,1411,0,323
센트럴파크역,38574,930,2660,930,2660,0,115
센트럴파크푸르지오아파트,38544,1939,1199,1936,1199,3,101
센트럴파크푸르지오아파트,38545,1028,1731,1027,1731,1,89
센트럴푸르지오501동앞,92071,1535,426,1535,426,0,63
셀트리온(주),38319,182,408,182,408,0,19
셀트리온(주)앞,38513,434,360,434,360,0,25
셀트리온2공장앞,38474,1172,788,1172,788,0,63
셀트리온2공장앞,38475,1753,826,1753,826,0,83
소게,43185,2,119,1,119,1,3
소게,43243,94,0,91,0,3,3
소구월사거리,39266,5050,11812,5033,11812,17,543
소구월사거리,39268,4551,3535,4507,3535,44,260
소나무,43396,65,0,65,0,0,2
소나무,43805,0,47,0,47,0,1
소담(장미)마을입구,90236,0,4,0,4,0,0
소담(장미)마을입구,90237,5,0,5,0,0,0
소동,43412,83,1,82,1,1,2
소동,43829,2,196,2,196,0,6
소똑골 입구,90424,7,3,7,3,0,0
소래도서관,39829,10,379,7,379,3,12
소래산등산로입구,39770,0,44,0,44,0,1
소래산등산로입구,39771,21,3,21,3,0,0
소래산입구,39668,1,441,1,441,0,14
소래산입구,39670,575,5,575,5,0,18
소래역사관,39816,169,1430,168,1430,1,51
소래역사관,39817,3051,117,3038,117,13,102
소래초등학교,39615,290,335,290,335,0,20
소래포구,39815,734,78,729,78,5,26
소래포구,39818,70,2750,70,2750,0,90
소래포구 해오름광장,92074,61,1239,61,1239,0,41
소래포구역,39647,3532,1527,3532,1527,0,163
소래포구역,39648,2610,5571,2608,5571,2,263
소래포구역,39710,1514,33,1501,33,13,49
소래포구역앞,92063,2387,1069,2387,1069,0,111
소래포구역종점,39793,865,40,849,40,16,29
소래포구입구,70009,822,200,814,200,8,32
소래포구입구(논현푸르지오A),39109,377,928,375,928,2,42
소래포구입구(논현푸르지오A),39114,291,174,291,174,0,15
소래풍림아파트,39122,2583,738,2567,738,16,107
소리공원(하모니로),38721,687,856,683,856,4,49
소리공원(하모니로),38722,217,454,217,454,0,21
소망탑빌라,40116,13,371,13,371,0,12
소방대앞,90022,12,74,12,74,0,2
소방대앞,90023,226,20,226,20,0,7
소산서원,70011,201,791,201,791,0,32
소산서원,70012,354,377,354,377,0,23
소장전,43996,10,25,10,25,0,1
소장전,43997,4,3,4,3,0,0
소촌마을,41662,169,11,169,11,0,5
속아지,43344,30,0,27,0,3,0
속아지,43848,0,20,0,20,0,0
솔밭마을,38193,903,303,903,303,0,38
솔빛마을,36034,8940,9176,8920,9176,20,584
솔빛마을,36037,5932,6411,5928,6411,4,398
솔빛마을주공아파트,36049,9992,6913,9987,6913,5,545
솔빛마을주공아파트,36050,9887,11994,9882,11994,5,705
솔빛주공2단지,36045,972,741,959,741,13,55
솔안공원,38348,11636,6692,11623,6692,13,591
솔정,43526,24,1,22,1,2,0
솔정,43871,2,17,2,17,0,0
솔정1리마을회관,90085,0,1,0,1,0,0
솔정마을,43129,52,8,49,8,3,1
솔정마을,43811,8,2,8,2,0,0
솔정마을,43872,25,63,22,63,3,2
솔정마을,90108,0,8,0,8,0,0
솔정정미소,43130,20,11,20,11,0,1
솔정정미소,43134,33,9,33,9,0,1
솔터마을입구,80327,1039,317,1036,317,3,43
솔터마을입구,80336,1127,997,1126,997,1,68
솔펜션,44177,0,1,0,1,0,0
송곡촌,43439,23,44,23,44,0,2
송곡촌,43815,59,21,58,21,1,2
송내고교입구,11014,77,444,77,444,0,16
송내고교입구,11015,705,152,705,152,0,27
송내고등학교,40219,2285,2886,2278,2886,7,166
송내남부역,40761,45,1253,45,1253,0,41
송내역.로데오거리,55267,5183,26853,5181,26853,2,1033
송내역.영화의거리,55263,22939,6714,22936,6714,3,956
송내역남부,56002,90698,73860,90698,73860,0,5308
송내역남부,56005,103313,83439,103219,83439,94,6024
송담초등학교,38667,2507,796,2507,796,0,106
송담초등학교,38668,877,2424,877,2424,0,106
송도1동행정복지센터,38012,5648,13633,5643,13633,5,621
송도2동행정복지센터,38492,5056,2998,5048,2998,8,259
송도2동행정복지센터,38588,1352,2267,1352,2267,0,116
송도MTB파크,38746,200,279,200,279,0,15
송도SK뷰(101동),38635,1795,978,1795,978,0,89
송도SK뷰(105동),38632,205,686,205,686,0,28
송도SK뷰(105동),38633,1103,209,1103,209,0,42
송도sk뷰,38707,971,3853,963,3853,8,155
송도sk뷰,38708,720,1496,720,1496,0,71
송도고입구,38215,3617,2412,3614,2412,3,194
송도고입구,38221,1558,908,1554,908,4,79
송도공영차고지,38472,580,68,580,68,0,20
송도국제교입구,38597,269,0,269,0,0,8
송도국제도시디에트르시그니처뷰,38771,2812,1627,2812,1627,0,143
송도글로벌캠퍼스푸르지오아파트,38711,804,670,804,670,0,47
송도누리공원,38663,4016,4725,4016,4725,0,281
송도누리공원,38664,1084,3654,1084,3654,0,152
송도달빛축제공원,38776,281,371,281,371,0,21
송도달빛축제공원역,38696,20971,3683,20964,3683,7,795
송도달빛축제공원역,38697,3049,16651,3049,16651,0,635
송도더샵그린스퀘어,39843,3536,1573,3533,1573,3,164
송도더샵그린워크,38526,1118,294,1118,294,0,45
송도더샵그린워크2차,38493,2262,3159,2261,3159,1,174
송도더샵마스터뷰21단지,38578,6185,985,6182,985,3,231
송도더샵마스터뷰22단지,38693,760,410,760,410,0,37
송도더샵마스터뷰22단지(2202동),38698,240,492,240,492,0,23
송도더샵마스터뷰22단지(2202동),38712,395,1356,395,1356,0,56
송도더샵마스터뷰22단지(정문),38694,357,1387,357,1387,0,56
송도더샵마스터뷰22단지(하행),38695,354,560,354,560,0,29
송도더샵마스터뷰23단지,38441,3278,3204,3276,3204,2,209
송도더샵마스터뷰23단지,38442,592,6308,590,6308,2,222
송도더샵마스터뷰23단지(정문),38692,1615,331,1615,331,0,62
송도더샵센트럴시티,39842,2411,3337,2403,3337,8,185
송도더샵센트럴시티.글로벌캠퍼스푸르지오,38647,5572,1235,5572,1235,0,219
송도더샵퍼스트월드,38589,1059,1578,1059,1578,0,85
송도더샵퍼스트월드(동문),38013,18029,6997,18021,6997,8,807
송도더샵퍼스트월드(서문),38381,3495,1497,3491,1497,4,161
송도더샵퍼스트월드B동.C동,38425,3979,2390,3979,2390,0,205
송도더샵퍼스트월드D동,38009,1868,1813,1866,1813,2,118
송도더샵퍼스트파크14단지,38560,538,3870,533,3870,5,142
송도더샵퍼스트파크14단지,38577,2869,344,2869,344,0,103
송도더샵퍼스트파크15단지,38559,237,1034,235,1034,2,41
송도더샵퍼스트파크15단지,38576,1045,164,1045,164,0,39
송도더샵하버뷰2차,38467,2593,13107,2585,13107,8,506
송도동일하이빌파크포레아파트,38680,2886,1087,2876,1087,10,128
송도라마다호텔앞,38065,2304,4815,2298,4815,6,229
송도라마다호텔앞,38067,11996,8113,11973,8113,23,648
송도랜드마크시티13호근린공원,38738,652,2383,652,2383,0,97
송도랜드마크시티13호근린공원,38739,1670,505,1670,505,0,70
송도랜드마크푸르지오시티,38747,998,1887,998,1887,0,93
송도베르디움더퍼스트후문,39985,1514,5035,1514,5035,0,211
송도세브란스병원,38651,25,780,25,780,0,25
송도센트럴파크,38452,2780,6264,2780,6264,0,291
송도센트럴파크역,38563,2051,995,2040,995,11,98
송도소방서(송도스마트밸리),39801,1680,2631,1680,2631,0,139
송도스마트밸리,39802,4158,1671,4158,1671,0,188
송도스포츠센터(LNG야구장),39721,1593,1102,1593,1102,0,86
송도아트윈푸르지오,38549,643,562,635,562,8,38
송도아트윈푸르지오,38562,1,391,1,391,0,12
송도에듀포레푸르지오,39921,1513,3040,1513,3040,0,146
송도에듀포레푸르지오후문,39986,5262,989,5262,989,0,201
송도역,38213,2418,1796,2418,1796,0,135
송도역,38505,8576,16345,8570,16345,6,803
송도역,38669,1002,1494,1002,1494,0,80
송도영남아파트,38224,8823,6791,8822,6791,1,503
송도오션파크베르디움,38642,1231,18528,1230,18528,1,637
송도요양원,38144,1709,2444,1709,2444,0,133
송도유원지(도로교통공단),38081,11301,12812,11258,12812,43,777
송도유원지(도로교통공단),38088,19309,7547,19257,7547,52,866
송도자이하버뷰,38521,3085,1985,3085,1985,0,163
송도자이하버뷰1단지,38468,17471,2439,17465,2439,6,642
송도자이하버뷰2단지(202동),38488,1719,3438,1703,3438,16,166
송도자이하버뷰2단지(205동),38455,551,486,551,486,0,33
송도자이하버뷰2단지(정문),38465,2824,1918,2823,1918,1,152
송도자이하버뷰2단지(정문),38498,2098,1868,2097,1868,1,127
송도재래시장,38207,5907,7595,5894,7595,13,435
송도재래시장,38210,8891,7562,8886,7562,5,530
송도재래시장,38220,6124,2220,6124,2220,0,269
송도제2차고지,38703,740,28,709,28,31,24
송도제2차고지입구,38735,516,820,509,820,7,43
송도중학교,35155,12321,13031,12293,13031,28,817
송도지웰푸르지오시티,38424,6660,10287,6649,10287,11,546
송도채석장,38175,598,2181,598,2181,0,89
송도체육센터,38699,175,803,175,803,0,31
송도체육센터,38700,801,205,800,205,1,32
송도컨벤시아,38367,1795,6154,1793,6154,2,256
송도컨벤시아,38369,2427,1444,2422,1444,5,124
송도컨벤시아남문,38660,2450,1242,2450,1242,0,119
송도컨벤시아남문,38661,1226,2321,1226,2321,0,114
송도타임스페이스,38720,2048,6560,2044,6560,4,277
송도테크노파크IT센터,38752,18,1078,16,1078,2,35
송도테크노파크IT센터,39929,4600,2332,4600,2332,0,223
송도파크레인동일하이빌,38625,20,87,20,87,0,3
송도파크레인동일하이빌,38626,679,1,679,1,0,21
송도파크레인입구,38538,538,3217,538,3217,0,121
송도파크레인입구,38539,1313,1448,1313,1448,0,89
송도파크자이,38627,679,461,678,461,1,36
송도파크자이,38628,2,511,2,511,0,16
송도파크자이아파트,38638,9147,8544,9122,8544,25,570
송도파크자이아파트정문,38677,1170,5157,1170,5157,0,204
송도푸르지오월드마크,38426,5948,6852,5948,6852,0,412
송도푸르지오하버뷰,38494,3298,4580,3297,4580,1,254
송도풍림아이원1단지,38033,3269,26223,3256,26223,13,951
송도풍림아이원2단지,38025,10272,15910,10258,15910,14,844
송도풍림아이원2단지,38026,10031,5710,10019,5710,12,507
송도풍림아이원2단지,38034,26465,2939,26447,2939,18,948
송도풍림아이원4단지,38032,4088,9792,4077,9792,11,447
송도힐스테이트,38479,17078,6946,17071,6946,7,774
송도힐스테이트5단지,38393,5965,7202,5963,7202,2,424
송도힐스테이트6단지,38554,13,86,13,86,0,3
송동마을.서초힐스아파트,22962,1647,130,1647,130,0,57
송림119안전센터,36165,45,246,45,246,0,9
송림3.5동행정복지센터(재능대정문),36030,1667,8089,1667,8089,0,314
송림4동행정복지센터(재능대후문),36127,2102,2152,2098,2152,4,137
송림고가교,37491,2461,1355,2456,1355,5,123
송림고가교,37492,1193,2514,1193,2514,0,119
송림고개(도화신동아아파트),37439,9927,8919,9907,8919,20,607
송림고개(도화신동아아파트),37501,11321,7877,11297,7877,24,619
송림동진로아파트,36154,325,300,325,300,0,20
송림동진로아파트,36155,101,764,101,764,0,27
송림빌라,43316,37,0,37,0,0,1
송림빌라,43775,1,30,1,30,0,1
송림시장,36015,228,363,228,363,0,19
송림오거리,36131,14550,3707,14534,3707,16,588
송림오거리,36132,3480,9767,3471,9767,9,427
송림주유소,36090,623,435,623,435,0,34
송림체육관,36130,468,63,468,63,0,17
송림체육관,36148,32,281,32,281,0,10
송림체육관후문,36152,261,718,261,718,0,31
송림체육관후문,36153,646,343,645,343,1,31
송림휴먼시아,36124,5,822,5,822,0,26
송림휴먼시아,36125,39,1446,39,1446,0,47
송마3리,80157,985,23,983,23,2,32
송마3리,80158,21,409,21,409,0,13
송마리입구,80159,70,757,70,757,0,26
송마리입구,80160,390,178,388,178,2,18
송명초등학교,92013,3665,432,3665,432,0,132
송산,43482,59,17,59,17,0,2
송산,43710,39,78,34,78,5,3
송산교회,43956,15,23,15,23,0,1
송산삼거리,43480,52,4,51,4,1,1
송산삼거리,43611,2,37,2,37,0,1
송암박두성생가입구,90396,0,20,0,20,0,0
송암박두성생가입구,90397,24,0,23,0,1,0
송월동동화마을,35189,6071,3259,6045,3259,26,300
송월동동화마을,35190,3208,8298,3206,8298,2,371
송월아파트,35193,2778,628,2778,628,0,109
송월아파트,35194,979,3130,979,3130,0,132
송정역,25184,56,3688,56,3688,0,120
송정역,,5674,76,5674,76,0,185
송학둥지아파트,38584,4324,4409,4315,4409,9,281
송학둥지아파트,38585,3297,3415,3295,3415,2,216
송해교회,43384,286,84,281,84,5,11
송해교회,43769,87,318,87,318,0,13
송해면사무소,43708,32,136,32,136,0,5
송해면사무소,43809,84,32,84,32,0,3
송해삼거리,43386,401,96,398,96,3,16
송해삼거리,43819,80,549,79,549,1,20
송해초등학교,43807,33,170,33,170,0,6
송해초등학교,43820,146,18,144,18,2,5
송현시장.수도국산달동네박물관,36019,7705,5538,7664,5538,41,427
송현시장.수도국산달동네박물관,36020,6041,22351,6021,22351,20,915
송현시장.수도국산달동네박물관,36025,47,580,44,580,3,20
송현아파트,36065,5827,3464,5824,3464,3,299
송현아파트,36067,1952,4136,1952,4136,0,196
송현주공아파트,36073,821,2679,821,2679,0,112
송현주공아파트,36080,10523,5322,10501,5322,22,511
송현주공아파트후문,36162,582,2862,581,2862,1,111
쇠골큰말,89318,87,54,87,54,0,4
쇠골큰말,89321,63,24,61,24,2,2
수곡(월곳리),43191,36,0,36,0,0,1
수곡(월곳리),43620,0,13,0,13,0,0
수광티티아이,90215,35,32,35,32,0,2
수도군수지원단(장애인복지관),40825,5789,1519,5780,1519,9,235
수도군수지원단(장애인복지관),40826,17,1826,14,1826,3,59
수림공원,39347,1619,788,1619,788,0,77
수림공원,39351,792,1616,792,1616,0,77
수변로삼거리,40367,1026,607,1026,607,0,52
수변로삼거리,40370,2676,5281,2676,5281,0,256
수봉공원,37289,1680,1597,1680,1597,0,105
수봉공원,37569,1205,3620,1205,3620,0,155
수봉공원.인천수봉문화회관입구,37362,12628,6714,12609,6714,19,623
수봉공원.인천수봉문화회관입구,37369,8580,13788,8579,13788,1,721
수봉마을쉼터,37570,2920,3754,2920,3754,0,215
수봉마을쉼터,37571,2911,1970,2911,1970,0,157
수부촌,43041,154,241,154,241,0,12
수산동,39175,362,731,360,731,2,35
수산동,39176,285,433,285,433,0,23
수양관,43245,22,43,21,43,1,2
수양관,43645,92,19,92,19,0,3
수인곡물시장,35134,2930,2436,2901,2436,29,173
수정제입구,90290,8,6,8,6,0,0
수촌,43111,109,3,104,3,5,3
수촌,43358,3,105,3,105,0,3
수출산업단지6공단입구,40009,3886,4790,3877,4790,9,279
수출산업단지6공단입구,40010,2210,2524,2208,2524,2,152
수행마을.홈플러스,80074,764,34,764,34,0,25
수행마을.홈플러스,80075,107,637,107,637,0,24
수현마을,39487,2308,3300,2305,3300,3,180
수현마을,39488,5560,4931,5542,4931,18,338
수협,43060,178,1068,177,1068,1,40
수협,43062,3366,9717,3338,9717,28,422
수협(인천해양센터),35080,2709,117,2685,117,24,91
수협(인천해양센터),35081,50,4145,49,4145,1,135
수협온수지점,90411,1406,506,1399,506,7,61
수협온수지점,90413,367,1489,364,1489,3,59
순복음교회,37253,8517,28447,8510,28447,7,1192
순복음교회,39181,19713,7965,19657,7965,56,892
순복음교회,40661,13424,7587,13424,7587,0,677
순천향대학병원.부명고,55037,7813,1027,7811,1027,2,285
숭덕여중고입구,39461,11766,24042,11733,24042,33,1155
숭덕여중고입구,39463,15788,12761,15751,12761,37,920
숭덕여중고입구,39466,6174,920,6084,920,90,228
숭뢰2리,43421,100,231,94,231,6,10
숭뢰2리,43704,211,32,208,32,3,7
숭보사입구,40851,149,24,149,24,0,5
숭보사입구,40918,1,62,1,62,0,2
숭의1.3동(극동아파트),37328,592,650,589,650,3,40
숭의1.3동(극동아파트),37337,460,864,457,864,3,42
숭의2동행정복지센터,37563,1897,2274,1897,2274,0,134
숭의교회,37269,17712,10622,17703,10622,9,914
숭의교회,37271,12758,15585,12755,15585,3,914
숭의로터리,37265,5867,18678,5846,18678,21,791
숭의로터리,37266,15661,5869,15634,5869,27,694
숭의로터리,37273,18802,8500,18783,8500,19,880
숭의로터리.도원체육관,37276,8196,13245,8189,13245,7,691
숭의목공예마을앞,37313,8239,8998,8237,8998,2,556
숭의목공예마을앞,37315,6408,7112,6400,7112,8,436
숭의박문아파트,37353,1304,2328,1296,2328,8,117
숭의박문아파트,37354,2467,1307,2457,1307,10,121
숭의보건지소,37532,13694,3913,13687,3913,7,567
숭의역(1번출구),37510,44980,22011,44922,22011,58,2161
숭의역(2번출구),37211,26505,33849,26483,33849,22,1946
숭의역(3번출구),35133,1055,4246,1053,4246,2,171
숭의역(4번출구),35135,4006,2462,4004,2462,2,208
숭의초등학교,37296,1167,599,1157,599,10,56
숭의초등학교,37308,1315,3809,1315,3809,0,165
숭의초등학교입구,37287,1748,1535,1743,1535,5,105
쉐보레인천서비스,40433,1405,4485,1404,4485,1,190
쉐보레출고사무소,89160,1977,19,1977,19,0,64
쉴낙원인천장례식장,41458,1272,2568,1272,2568,0,123
스카이시티자이.화성파크드림,35650,2925,6666,2925,6666,0,309
스타파이브입구,35428,421,46,421,46,0,15
스타파이브입구,35429,15,362,15,362,0,12
스태츠칩팩코리아,35641,10,498,10,498,0,16
스태츠칩팩코리아,35642,432,10,432,10,0,14
스틸랜드,70228,137,509,137,509,0,20
스틸랜드,70229,371,158,371,158,0,17
스포월드골프연습장,42439,93,147,93,147,0,7
스포월드골프연습장,42440,19,111,16,111,3,4
승기천,39169,1079,6130,1077,6130,2,232
승기천,39170,691,4189,690,4189,1,157
시대아파트,38340,15648,12273,15648,12273,0,900
시리미,43330,49,57,49,57,0,3
시리미,43631,15,0,15,0,0,0
시립가좌테니스장,37581,239,1353,239,1353,0,51
시립가좌테니스장,37582,179,2682,179,2682,0,92
시민공원,37359,14624,5571,14591,5571,33,651
시민공원(문화창작지대)역,37344,24140,23605,24115,23605,25,1540
시민공원(문화창작지대)역,37346,33756,28779,33725,28779,31,2017
시민공원.문화창작지대,37334,17896,33957,17860,33957,36,1672
시민공원.문화창작지대,37468,1822,1317,1822,1317,0,101
시민공원역.포레나미추홀,37319,5066,50327,5057,50327,9,1786
시민공원역.포레나미추홀,37326,102525,18597,102416,18597,109,3907
시민의숲.양재꽃시장,31002,14941,4754,14941,4754,0,635
시민의숲.양재꽃시장,31003,1889,5850,1889,5850,0,249
시장로터리(중앙철재),40261,2169,1737,2165,1737,4,126
시청광장입구,39217,16360,21485,16360,21485,0,1220
시청광장입구,39218,21886,16973,21877,16973,9,1253
시흥대야역.영남아파트,70027,465,1905,465,1905,0,76
시흥대야역.영남아파트,70028,2132,772,2132,772,0,93
시흥보건소,70015,1810,447,1810,447,0,72
시흥보건소,70016,462,1787,462,1787,0,72
시흥영업소,25846,193,93,193,93,0,9
시흥영업소,25847,83,147,83,147,0,7
신골입구,43998,11,41,11,41,0,1
신골입구,43999,34,15,34,15,0,1
신광주유소,43470,7,6,7,6,0,0
신광주유소,43524,8,9,8,9,0,0
신광초등학교,35142,301,518,301,518,0,26
신기.남부종합시장(진흥사거리),37217,49691,30061,49592,30061,99,2572
신기.남부종합시장(진흥사거리),37219,16094,29896,16071,29896,23,1483
신김포농협대곶지점,80147,70,38,70,38,0,3
신김포농협대곶지점,80148,180,157,178,157,2,10
신논현역,32055,10433,71,10433,71,0,338
신논현역.우신빌딩,31057,79,6188,79,6188,0,202
신당리동촌부락,90090,32,0,32,0,0,1
신당리동촌부락,90091,2,4,2,4,0,0
신당리마을회관,90087,1,1,1,1,0,0
신당리마을회관,90088,0,2,0,2,0,0
신당촌,90114,3,4,3,4,0,0
신대진중앙아파트,41271,4071,2826,4071,2826,0,222
신대진중앙아파트,41274,2017,3641,2017,3641,0,182
신도실업(주),40625,522,1765,522,1765,0,73
신동마을,90253,1,3,1,3,0,0
신동마을,90254,7,3,7,3,0,0
신동아1.2차아파트,37507,9089,6137,9078,6137,11,491
신동아1단지,70038,126,210,126,210,0,10
신동아1단지.한일아파트,70037,220,278,220,278,0,16
신동아3차아파트,37119,11942,16677,11942,16677,0,923
신동아3차아파트,37120,11685,18365,11685,18365,0,969
신동아3차아파트,37494,10017,6219,9994,6219,23,523
신동아상가,40860,5157,3528,5157,3528,0,280
신동아상가(백운역방면),40068,5460,8335,5460,8335,0,445
신동아아파트,37072,10,1062,10,1062,0,34
신동아아파트,37143,9079,14023,9079,14023,0,745
신동아아파트,37160,6037,8252,6037,8252,0,460
신동아아파트,37525,2467,8115,2463,8115,4,341
신동아아파트,39381,3015,6865,3015,6865,0,318
신동아아파트,39382,17251,6633,17243,6633,8,770
신동아아파트,41349,7907,1242,7907,1242,0,295
신동아아파트,41350,1788,6273,1788,6273,0,260
신동아아파트(B),37162,11827,10531,11827,10531,0,721
신동아아파트116동,40060,3404,11394,3404,11394,0,477
신동아아파트116동,40859,7552,2711,7552,2711,0,331
신동아아파트3차,37090,10620,1171,10620,1171,0,380
신동아아파트3차,37097,3608,9418,3608,9418,0,420
신동아아파트4차,37121,4784,1925,4784,1925,0,216
신동아아파트4차,37123,2914,3626,2914,3626,0,210
신동아아파트5차,37141,13227,4091,13227,4091,0,558
신동아아파트8차,37135,1765,3527,1765,3527,0,170
신동아아파트8차,37136,4713,1077,4713,1077,0,186
신동양아파트,41202,3835,10177,3835,10177,0,452
신동양아파트,41203,8985,4371,8985,4371,0,430
신라아파트,37277,7026,6645,7011,6645,15,441
신라아파트,37543,1774,3926,1770,3926,4,183
신명보람마을.삼부한신아파트,40511,2390,2735,2390,2735,0,165
신명보람마을.삼부한신아파트,40512,559,1017,559,1017,0,50
신명스카이뷰,35453,1725,3362,1725,3362,0,164
신명스카이뷰,35456,9460,4725,9460,4725,0,457
신명스카이뷰,42737,88,216,88,216,0,9
신명스카이뷰정문,35455,4962,8978,4962,8978,0,449
신명아파트,42081,8205,11715,8195,11715,10,642
신명아파트.대우3차아파트,70018,412,3031,412,3031,0,111
신명아파트앞,42799,16,873,16,873,0,28
신반포역.세화여중고,31033,850,55,850,55,0,29
신봉삼거리,43126,131,6,131,6,0,4
신봉삼거리,43127,3,9,3,9,0,0
신봉삼거리,43463,620,624,608,624,12,40
신봉삼거리,43814,25,15,25,15,0,1
신봉이발관,43458,32,9,31,9,1,1
신봉이발관,43786,12,46,12,46,0,1
신북항고가교,42104,2228,2048,2228,2048,0,137
신북항고가교,42109,1370,2996,1370,2996,0,140
신분당선.강남역4번출구,23572,8637,3971,8637,3971,0,406
신비마을아파트,37164,441,2075,439,2075,2,81
신비마을아파트,37223,4380,8096,4370,8096,10,402
신비마을아파트,37225,7111,3915,7086,3915,25,355
신비마을아파트,37555,230,1187,230,1187,0,45
신비마을아파트(112동),37171,5641,3714,5618,3714,23,301
신삼1리마을회관,43405,143,1,139,1,4,4
신삼1리마을회관,43791,2,148,2,148,0,4
신삼2리마을회관,43400,142,0,138,0,4,4
신삼2리마을회관,43825,6,91,6,91,0,3
신삼리입구,43606,4,2,4,2,0,0
신삼리입구,43801,2,30,2,30,0,1
신선지입구,90346,9,1,9,1,0,0
신선지입구,90347,9,27,9,27,0,1
신선초등학교,35086,5707,9873,5703,9873,4,502
신선초등학교(유림노르웨이숲),35089,11204,4004,11188,4004,16,490
신선초등학교앞,37055,3031,918,3023,918,8,127
신설동,35413,9,47,9,47,0,1
신설동,35416,38,9,38,9,0,1
신설동(3거리),35018,92,8,92,8,0,3
신설동(3거리),35019,6,135,6,135,0,4
신성미소지움,40099,2540,31,2518,31,22,82
신성미소지움,40102,19,1934,17,1934,2,63
신성미소지움,40643,2094,14863,2094,14863,0,547
신성미소지움,40649,7109,2167,7109,2167,0,299
신성미소지움후문,40660,10,583,10,583,0,19
신성성결교회(올림피아병원),39355,14094,9433,14086,9433,8,758
신세계아파트,39383,3634,5023,3633,5023,1,279
신송고등학교,38023,1683,4427,1678,4427,5,197
신송고등학교,38024,4472,2757,4470,2757,2,233
신안실크밸리,35220,889,300,889,300,0,38
신연수역(1번출구),38263,4291,4056,4277,4056,14,269
신연수역(2번출구),38231,2914,623,2914,623,0,114
신연수역(3번출구),38228,6683,4590,6674,4590,9,363
신영자동차,40561,3173,748,3168,748,5,126
신영자동차(종점),40556,5175,1991,5157,1991,18,231
신왕마을,43203,203,5,200,5,3,6
신왕마을,43718,5,152,5,152,0,5
신원기술,39130,31,11,31,11,0,1
신원아침도시오피스텔(홈플러스),39836,6032,7690,6031,7690,1,442
신일교회,39529,4733,7580,4733,7580,0,397
신일아파트,35097,50,16,50,16,0,2
신정1리마을회관,43300,16,11,15,11,1,0
신정1리마을회관,43737,29,24,29,24,0,1
신정삼거리,90111,0,18,0,18,0,0
신정삼거리,90112,5,6,5,6,0,0
신정중학교,38459,2058,2459,2058,2459,0,145
신정중학교,38555,3072,2046,3072,2046,0,165
신중동역4번출구.롯데백화점,55226,1311,5071,1311,5071,0,205
신중동역5번출구.중흥중학교,55071,626,5070,626,5070,0,183
신중동역6번출구.중흥중학교,55072,2914,423,2914,423,0,107
신지동마을회관,43303,61,68,61,68,0,4
신지동마을회관,43740,92,48,86,48,6,4
신진아파트,41107,24664,14702,24664,14702,0,1269
신창아파트,37010,3249,6660,3245,6660,4,319
신창아파트,37464,5015,2319,5015,2319,0,236
신천동,70048,6301,466,6301,466,0,218
신천동,70049,316,6541,316,6541,0,221
신천삼거리,70013,6702,476,6702,476,0,231
신천삼거리,70014,441,7049,441,7049,0,241
신천역.문화의거리,25364,1805,314,1805,314,0,68
신천역.문화의거리,70174,228,1981,228,1981,0,71
신천연합병원,70175,60,760,60,760,0,26
신천연합병원,70231,831,245,831,245,0,34
신촌,43146,26,0,26,0,0,0
신촌,43432,8,26,8,26,0,1
신촌,43459,299,18,296,18,3,10
신촌,43510,0,12,0,12,0,0
신촌,43753,15,213,15,213,0,7
신촌,43800,63,47,63,47,0,3
신촌마을입구,90201,40,10,40,10,0,1
신촌마을입구,90202,4,6,4,6,0,0
신촌역2호선,22052,4383,44,4383,44,0,142
신촌오거리.2호선신촌역,22014,5057,66,5057,66,0,165
신촌오거리.2호선신촌역,23035,175,2861,175,2861,0,97
신촌오거리.현대백화점,22013,11321,98,11321,98,0,368
신촌오거리.현대백화점,23034,404,14861,404,14861,0,492
신촌초등학교,40098,353,866,353,866,0,39
신태양아파트,37406,5291,7593,5291,7593,0,415
신태양아파트,37408,8771,3635,8771,3635,0,400
신트리공원,40472,2369,2344,2369,2344,0,152
신트리공원,40496,2755,4271,2754,4271,1,226
신트리공원,40501,2133,1504,2131,1504,2,117
신포동행정복지센터,35153,3673,2347,3671,2347,2,194
신포동행정복지센터,35154,1971,3095,1969,3095,2,163
신포사거리,35791,53,240,53,240,0,9
신포시장,35160,32402,54830,32359,54830,43,2813
신포시장,35254,57626,34210,57551,34210,75,2962
신포역·인천세관역사공원,35792,285,105,285,105,0,12
신포역·인천세관역사공원,35796,4,10,4,10,0,0
신포역·인천여자상업고등학교,35149,1541,7295,1531,7295,10,285
신포역·인천여자상업고등학교,35150,7013,2391,7010,2391,3,303
신포입구,43491,52,38,51,38,1,2
신포입구,43842,6,20,6,20,0,0
신한빌딩,39901,10758,9934,10758,9934,0,667
신한에이엠,89147,621,17,621,17,0,20
신한일전기,39034,1668,991,1668,991,0,85
신현119안전센터,42596,8219,12903,8193,12903,26,681
신현119안전센터,42600,7571,7933,7557,7933,14,500
신현노인회관,43279,59,5,57,5,2,2
신현노인회관,43527,22,44,22,44,0,2
신현리입구,90062,28,77,28,77,0,3
신현북초등학교,42208,4081,546,4081,546,0,149
신현북초등학교,42209,562,3230,562,3230,0,122
신현북초등학교,42210,1611,204,1607,204,4,58
신현북초등학교,42211,95,1787,95,1787,0,60
신현쇼핑,42217,31907,23319,31828,23319,79,1781
신현쇼핑,42220,40085,25280,40026,25280,59,2108
신현여자중학교후문,42214,3337,4026,3337,4026,0,237
신현여자중학교후문,42680,3151,1800,3151,1800,0,159
신현중학교,42205,281,3035,281,3035,0,106
신현초등학교,42178,1519,1861,1519,1861,0,109
신현초등학교,42179,2249,3057,2249,3057,0,171
신화빌라,42626,558,468,556,468,2,33
신화슈퍼,89314,118,1,110,1,8,3
신화슈퍼,89326,6,126,6,126,0,4
신흥교통,35501,210,10,209,10,1,7
신흥교통입구,35841,1480,192,1477,192,3,53
신흥동주민자치센터,35789,202,71,202,71,0,8
신흥동주민자치센터,35799,24,33,24,33,0,1
신흥시장,35145,12090,15802,12086,15802,4,899
신흥시장,35146,16473,9305,16462,9305,11,831
신흥시장,57002,2424,1254,2423,1254,1,118
신흥시장,57004,1599,2538,1599,2538,0,133
신흥시장후문,35812,124,44,124,44,0,5
신흥시장후문,35813,100,174,100,174,0,8
신흥주민지원센터,57013,3293,1838,3292,1838,1,165
신흥주민지원센터,57014,1730,2914,1730,2914,0,149
신흥초등학교,35156,7674,10737,7653,10737,21,593
실내게이트볼장(신현중학교),42204,4330,252,4330,252,0,147
실미도조개구이,35299,4,53,4,53,0,1
실미삼거리,35740,422,65,414,65,8,15
실미삼거리,35741,74,313,74,313,0,12
심곡극동아파트,42272,1650,350,1645,350,5,64
심곡극동아파트,42273,208,939,208,939,0,37
심곡도서관,42946,2145,1433,2134,1433,11,115
심곡도서관,89223,579,2194,578,2194,1,89
심곡동광명아파트,89153,6711,2077,6693,2077,18,283
심곡동광명아파트,89154,2455,4335,2449,4335,6,219
심곡천(심곡3교),89381,141,16,141,16,0,5
심곡천(심곡3교),89382,13,211,13,211,0,7
심곡천봉수교,42875,976,619,976,619,0,51
심곡천봉수교,42951,1547,5097,1546,5097,1,214
심곡초등학교(국제성모병원),42288,4071,5400,4066,5400,5,305
심곡초등학교(국제성모병원),42290,5832,3992,5827,3992,5,316
십리포제2주차장,44110,13,36,13,36,0,1
십리포제2주차장,44207,13,0,13,0,0,0
십리포해수욕장,44088,78,88,78,88,0,5
십리포해수욕장,44208,43,7,43,7,0,1
십정1동행정복지센터,40049,18426,13687,18402,13687,24,1035
십정2동행정복지센터,40056,5343,6007,5340,6007,3,366
십정동차고지,40913,3038,437,3038,437,0,112
십정사거리,40029,6628,5556,6624,5556,4,393
십정사거리,40033,3389,3628,3387,3628,2,226
십정시장입구,40007,21,3874,21,3874,0,125
십정시장입구,40008,3703,25,3703,25,0,120
십정초등학교(동암의원),40041,1330,1031,1330,1031,0,76
십정초등학교(동암의원),40042,605,2311,605,2311,0,94
십정초등학교·더샵부평정문,40045,17957,20892,17903,20892,54,1253
십정초등학교·더샵부평정문,40048,27646,19063,27628,19063,18,1506
쌍마아파트,42112,5785,3323,5785,3323,0,293
쌍마아파트,42114,647,2562,647,2562,0,103
쌍용아파트,37179,5435,2504,5425,2504,10,256
쌍용아파트,37186,1932,4040,1932,4040,0,192
쌍용아파트,37210,609,416,609,416,0,33
쌍용아파트,37228,20081,11873,20038,11873,43,1030
쌍용아파트,37476,14360,22735,14316,22735,44,1196
쌍용아파트,38178,2064,781,2064,781,0,91
쌍용아파트,38184,830,1781,830,1781,0,84
쌍용아파트,38469,4934,2745,4914,2745,20,247
쌍용아파트,41434,1242,4311,1241,4311,1,179
쌍용아파트정문,40439,2562,3738,2562,3738,0,203
쌍용자동차인천정비사업소,36144,103,1182,103,1182,0,41
쑥골고가교,37371,2767,3029,2756,3029,11,186
쑥골고가교,37372,4952,8123,4948,8123,4,421
쑥밭다리,43650,7,8,6,8,1,0
쑥밭다리,43683,6,12,5,12,1,0
아나지고개,41001,2541,3016,2535,3016,6,179
아나지고개,41002,4295,6251,4290,6251,5,340
아동보호센터,35680,78,461,76,461,2,17
아동보호센터,35698,60,39,57,39,3,3
아라노을공원·한신더휴,89404,11555,10253,11555,10253,0,703
아라노을공원·한신더휴,89405,10831,11517,10831,11517,0,720
아라동행정복지센터,42465,14124,18091,14124,18091,0,1039
아라동행정복지센터,42467,13742,8735,13742,8735,0,725
아라동행정복지센터(서부고용센터),89401,3655,981,3655,981,0,149
아라동행정복지센터(서부고용센터),89402,1222,4909,1222,4909,0,197
아라뱃길물류센터,89145,0,401,0,401,0,12
아라센트럴파크,89406,2791,3956,2791,3956,0,217
아라센트럴파크,89407,4631,3449,4631,3449,0,260
아름어린이공원,40337,232,560,232,560,0,25
아름어린이공원,40339,974,490,974,490,0,47
아리마을쉼터,37551,17,1274,17,1274,0,41
아리마을쉼터,37552,1552,134,1536,134,16,54
아모텍,39139,1485,2432,1485,2432,0,126
아시아드경기장(공촌사거리)역,42319,2515,4223,2512,4223,3,217
아시아드경기장(공촌사거리)역,42320,444,1467,442,1467,2,61
아시아드대광로제비앙아파트,89257,975,3565,974,3565,1,146
아시아드대광로제비앙아파트,89258,4514,1521,4514,1521,0,194
아암3교사거리,38727,45,316,45,316,0,11
아암3교사거리,38728,158,142,158,142,0,9
아암물류단지,35285,86,1,84,1,2,2
아암물류단지,35590,0,211,0,211,0,6
아울렛(CGV부평),40818,3806,2110,3806,2110,0,190
아이즈빌(부평CGV),40595,12433,7449,12425,7449,8,641
아이즈빌(부평CGV),40598,8816,12614,8812,12614,4,691
아인스월드,55086,430,1322,430,1322,0,56
아주아파트,38047,1571,772,1567,772,4,75
아주아파트,38051,762,1492,758,1492,4,72
아주아파트,38301,1536,944,1529,944,7,80
아주아파트,38304,2331,1607,2329,1607,2,127
아주아파트.미추홀학교,39481,42970,17588,42833,17588,137,1953
아주아파트.미추홀학교,39482,20723,26235,20714,26235,9,1514
아주아파트410동,41575,476,0,476,0,0,15
아침가리마을회관,43287,136,0,131,0,5,4
아침가리마을회관,43867,0,84,0,84,0,2
아쿠아글로리,42811,153,1,150,1,3,4
아트센터인천,38617,46,69,46,69,0,3
아트센터인천,38618,28,77,28,77,0,3
아현역,22062,3124,30,3124,30,0,101
아현역,23078,20,1872,20,1872,0,61
안골마을입구,38225,7613,8548,7613,8548,0,521
안남고(동보1차아파트),41048,731,748,731,748,0,47
안남고등학교,41045,3520,868,3520,868,0,141
안동포교회,42700,508,100,508,100,0,19
안동포교회,42701,47,696,47,696,0,23
안동포사거리,42707,44,146,44,146,0,6
안동포사거리입구,42765,347,26,347,26,0,12
안동포사거리입구,42766,6,974,6,974,0,31
안산마을,43132,58,0,57,0,1,1
안산마을,43138,1,69,1,69,0,2
안산초등학교(구계산고교),41425,15318,12558,15304,12558,14,899
안양대학교,43177,811,635,811,635,0,46
안양대학교,43301,1458,351,1452,351,6,58
안풍산업삼거리,89312,93,10,83,10,10,3
안풍산업삼거리,89329,0,68,0,68,0,2
알앤디써비스,38477,120,1511,118,1511,2,52
알앤디써비스,38478,987,191,987,191,0,38
애관극장,35804,13,76,13,76,0,2
애보박물관,39667,1,13,1,13,0,0
애보박물관,39671,8,50,8,50,0,1
애전마을,43682,13,4,13,4,0,0
애전마을,43894,42,39,42,39,0,2
애전부락,90075,44,57,44,57,0,3
애전부락,90076,60,89,60,89,0,4
앰코코리아(블루오션골프클럽),39880,1340,51,1340,51,0,44
야곡,43236,22,4,22,4,0,0
야곡,43292,8,86,6,86,2,3
야촌,43210,7,0,7,0,0,0
야촌,43333,0,12,0,12,0,0
약대사거리,57006,2852,557,2852,557,0,109
약대사거리,57010,383,3109,383,3109,0,112
약대주민지원센터.약대초등학교,55080,957,1632,957,1632,0,83
약대주민지원센터.약대초등학교,55088,1479,580,1477,580,2,66
약암호텔,80071,535,181,535,181,0,23
약암호텔,80072,56,505,56,505,0,18
얀센백신,38519,159,2,159,2,0,5
얀센백신,38520,1,395,1,395,0,12
양갑리마을회관,90283,6,66,6,66,0,2
양갑리마을회관,90307,60,0,56,0,4,1
양갑리입구,90282,0,11,0,11,0,0
양갑리입구,90308,13,1,13,1,0,0
양곡도매시장,31037,1438,438,1438,438,0,60
양곡버스정류장,80115,117,637,117,637,0,24
양곡사거리.양촌터미널,80116,427,180,421,180,6,19
양골,43987,17,0,17,0,0,0
양골,43989,1,32,1,32,0,1
양구(오상1리),43262,2,47,2,47,0,1
양구(오상1리),43563,71,6,66,6,5,2
양달마을,43910,39,56,38,56,1,3
양달마을,43911,4,0,4,0,0,0
양도,43074,1,20,1,20,0,0
양도,43075,20,23,19,23,1,1
양도면사무소(나무),43912,319,324,316,324,3,20
양도면사무소(쉘터),43913,559,296,547,296,12,27
양도사거리.대림아파트.신안아파트,80076,811,54,811,54,0,27
양도사거리.삼용아파트,80077,182,763,182,763,0,30
양도초등학교,43329,287,159,283,159,4,14
양도초등학교,43568,183,230,181,230,2,13
양로원,40111,543,2536,543,2536,0,99
양로원,40113,2037,472,2037,472,0,80
양사면사무소,43501,21,52,21,52,0,2
양사면사무소,43658,47,61,47,61,0,3
양사우체국,43465,39,26,39,26,0,2
양사우체국,43736,24,57,24,57,0,2
양사초등학교,43466,95,22,94,22,1,3
양사초등학교,43734,28,65,23,65,5,3
양사파출소,43722,13,11,13,11,0,0
양수장,43592,89,2,89,2,0,2
양수장,43781,0,137,0,137,0,4
양오1리마을회관,43454,7,60,7,60,0,2
양오1리마을회관,43666,57,1,56,1,1,1
양오2리경로당,43453,2,68,2,68,0,2
양오2리경로당,43625,136,5,135,5,1,4
양오2리앞,90049,0,15,0,15,0,0
양오리저수지마을,90102,0,11,0,11,0,0
양오리저수지마을,90103,106,1,104,1,2,3
양오저수지입구,90100,0,9,0,9,0,0
양오저수지입구,90101,14,0,14,0,0,0
양왕마을,43927,9,5,8,5,1,0
양왕마을,43928,4,43,4,43,0,1
양재역,31073,15095,4123,15095,4123,0,619
양재역.서초문화예술회관,31008,2398,4317,2398,4317,0,216
양재역.서초문화예술회관,31010,3097,2013,3097,2013,0,164
양재역말죽거리.강남베드로병원,23318,274,120,274,120,0,12
양지공원,38133,8115,5327,8115,5327,0,433
양지촌,43163,17,4,17,4,0,0
양지촌,43342,14,22,14,22,0,1
양진말입구,90057,0,42,0,42,0,1
양촌중학교,41629,486,907,486,907,0,44
양촌중학교,41630,298,500,298,500,0,25
양평해장국,44145,15,10,15,10,0,0
양평해장국,44178,4,9,4,9,0,0
어두,43206,3,11,3,11,0,0
어두,43280,3,0,3,0,0,0
어두마을,43155,93,3,92,3,1,3
어두마을,43322,5,54,5,54,0,1
어류정입구,90175,35,32,35,32,0,2
어류정입구,90176,7,40,7,40,0,1
어류정입구,90312,4,2,4,2,0,0
어류정항,90323,2,0,0,0,2,0
어류정항,90400,5,0,5,0,0,0
어린이집앞,43402,165,0,157,0,8,5
어린이집앞,43585,8,172,8,172,0,5
에덴하우스,42788,619,1512,619,1512,0,68
에몬스가구,39023,3059,4132,3055,4132,4,231
에몬스가구,39024,4930,2284,4930,2284,0,232
에스틸,89232,301,34,301,34,0,10
에이에프티,39110,1153,2674,1153,2674,0,123
에코메트로10단지,39728,452,225,452,225,0,21
에코메트로10단지,39736,121,339,121,339,0,14
에코메트로11단지,39652,2733,4298,2731,4298,2,226
에코메트로11단지후문,39701,797,1893,797,1893,0,86
에코메트로12단지,39651,3644,2346,3644,2346,0,193
에코메트로12단지,39653,40,698,40,698,0,23
에코메트로12단지정문,39650,105,152,105,152,0,8
에코메트로5단지,92076,22,109,22,109,0,4
에코메트로5단지·논현센트럴뷰,39779,676,1203,676,1203,0,60
에코메트로6단지,39716,3154,244,3141,244,13,109
에코메트로6단지,39758,123,929,123,929,0,33
에코메트로7단지,39714,9824,4834,9816,4834,8,472
에코메트로7단지,39715,5464,7143,5464,7143,0,406
에코메트로9단지,39750,7248,1168,7245,1168,3,271
에코메트로9단지,39752,2109,4905,2109,4905,0,226
에코메트로더타워,39711,80,632,77,632,3,22
에코크레이션,89449,205,0,205,0,0,6
에코크레이션,89450,1,75,1,75,0,2
엑스포빌리지10단지,38460,2799,1404,2794,1404,5,135
엑스포빌리지9단지,38482,3225,7035,3224,7035,1,330
엑슬루타워,37187,3241,9210,3233,9210,8,401
엑슬루타워,42836,3333,11919,3333,11919,0,492
엘리지안타운,42394,1330,1618,1330,1618,0,95
엘아이지식산업센터,39944,330,953,330,953,0,41
엘아이지식산업센터(맞은편),92029,614,265,614,265,0,28
엘지슈퍼,39457,1255,2233,1255,2233,0,112
엠파크타워,42025,4226,4531,4223,4531,3,282
엠파크타워,42026,4784,4408,4783,4408,1,296
여고입구,90232,441,538,432,538,9,31
여고입구,90233,1181,736,1175,736,6,61
여성의광장,38084,3268,4135,3266,4135,2,238
여성의광장,38085,4519,4658,4507,4658,12,296
여우고개,43980,18,98,18,98,0,3
여우고개,43981,87,72,87,72,0,5
여우별펜션,44142,8,14,8,14,0,0
여우별펜션,44179,6,4,6,4,0,0
여우재,35147,469,376,469,376,0,27
여의도역,19155,646,2,646,2,0,20
여의도역,19156,14,1373,14,1373,0,44
여의도환승센터,19007,23,492,23,492,0,16
여차리,43424,25,56,24,56,1,2
여차리,43472,59,28,58,28,1,2
여차리회관,43505,60,35,60,35,0,3
여차리회관,43525,58,22,55,22,3,2
역삼역.포스코타워역삼,23288,1282,1247,1282,1247,0,81
연락골,39662,7,38,7,38,0,1
연락골,39665,10,10,10,10,0,0
연리입구,43267,80,0,79,0,1,2
연리입구,43614,3,43,3,43,0,1
연미고개,43198,0,119,0,119,0,3
연미고개,43711,103,0,93,0,10,3
연미정,43193,178,2,172,2,6,5
연미정,43621,3,114,1,114,2,3
연성교회,37278,5885,5052,5872,5052,13,352
연세농장,39851,48,2,48,2,0,1
연세대,39725,4725,10238,4725,10238,0,482
연세대,39861,9354,5540,9354,5540,0,480
연세대송도캠퍼스입구,38489,9764,4724,9764,4724,0,467
연세대앞,22022,22,8,22,8,0,0
연세대학교앞,22058,6755,50,6755,50,0,219
연수1동행정복지센터,38248,269,550,269,550,0,26
연수1동행정복지센터,38251,1281,1312,1281,1312,0,83
연수1차아파트,38187,5619,2930,5617,2930,2,275
연수2차아파트,38195,711,1380,711,1380,0,67
연수3동행정복지센터,38262,1576,653,1576,653,0,71
연수경찰서,38111,3476,2670,3469,2670,7,198
연수고등학교,38104,771,2952,768,2952,3,120
연수구청,38089,9345,4648,9345,4648,0,451
연수구청,38093,4170,11266,4170,11266,0,497
연수구청입구,38095,5983,4782,5983,4782,0,347
연수꿈담도서관,38103,9231,6122,9226,6122,5,495
연수병원,38296,5206,2416,5205,2416,1,245
연수여자고등학교,38092,2733,3868,2730,3868,3,212
연수역,38506,2379,2732,2379,2732,0,164
연수역,38507,1402,2106,1402,2106,0,113
연수역북측입구,38572,1177,2684,1177,2684,0,124
연수역북측입구,38573,2091,2108,2091,2108,0,135
연수우체국,38280,7577,4551,7577,4551,0,391
연수우체국,38314,2306,1119,2306,1119,0,110
연수주공3차아파트,38188,3885,4174,3885,4174,0,259
연수중학교,38194,1992,1642,1992,1642,0,117
연수중학교,38196,970,1140,970,1140,0,68
연수초등학교,38290,11331,10216,11330,10216,1,695
연수초등학교,38293,4458,3872,4458,3872,0,268
연수한양1차아파트,38091,2849,5666,2849,5666,0,274
연안동행정복지센터,35063,121,11122,121,11122,0,362
연안부두(신선초등학교),35097,1415,3922,1398,3922,17,172
연안부두로삼거리,35754,1,701,1,701,0,22
연안부두바다쉼터,35049,1047,26,1035,26,12,34
연안부두어시장,35071,100,7446,99,7446,1,243
연안부두어시장,35072,8136,150,8105,150,31,267
연안아파트,35075,9893,2001,9853,2001,40,383
연안아파트,35076,1369,10672,1357,10672,12,388
연안여객터미널,35057,6252,49,6214,49,38,203
연안여객터미널,35061,26,4220,26,4220,0,136
연안여객터미널,90115,71,51,70,51,1,3
연안여객터미널,90116,17,97,17,97,0,3
연안여객터미널입구,35068,1934,49,1914,49,20,63
연안초등학교,35064,17590,268,17440,268,150,576
연안초등학교,35067,123,13104,119,13104,4,426
연지-기점,90256,3112,2965,3112,2965,0,196
연학초등학교,37137,7508,2308,7508,2308,0,316
연학초등학교,37138,1741,7426,1741,7426,0,295
연합의원,42186,4193,1688,4185,1688,8,189
연화중학교,38117,2700,3276,2700,3276,0,192
연흥아파트,37567,3611,4499,3605,4499,6,261
연흥아파트,37568,2322,6624,2315,6624,7,288
연희공원,42950,60,116,60,116,0,5
연희동광명아파트(사계절썰매장),42314,1716,1835,1711,1835,5,114
연희동광명아파트(사계절썰매장),42599,1413,2190,1408,2190,5,116
연희동행정복지센터,42311,679,1392,679,1392,0,66
연희동행정복지센터,42312,1628,1116,1626,1116,2,88
열우물사거리,40052,4,251,4,251,0,8
열우물전통시장,40028,485,2533,485,2533,0,97
열우물전통시장,40030,1962,521,1962,521,0,80
열우물전통시장입구,40036,2274,527,2274,527,0,90
열우물전통시장입구,40038,462,3709,462,3709,0,134
열우물테니스경기장,40053,3606,3547,3597,3547,9,230
열우물테니스경기장,40054,924,1067,924,1067,0,64
열우물테니스경기장,40063,378,1225,378,1225,0,51
열우물테니스경기장,40064,342,671,342,671,0,32
열우물테니스경기장,42023,4293,4469,4261,4469,32,282
열우물테니스경기장,42024,3096,3137,3071,3137,25,201
염전공원,37681,1914,4,1914,4,0,61
영골,43954,6,1,6,1,0,0
영골,43955,0,42,0,42,0,1
영남1단지.고합아파트,70164,241,231,241,231,0,15
영남아파트,37060,4426,3926,4426,3926,0,269
영남아파트,37063,5510,4744,5510,4744,0,330
영남아파트,38203,2658,1535,2658,1535,0,135
영남아파트,38205,1069,2975,1069,2975,0,130
영림몰딩도어,39943,61,191,61,191,0,8
영림산업,39028,775,3990,775,3990,0,153
영림임업,39026,1145,3902,1145,3902,0,162
영사목장 앞,90390,0,21,0,21,0,0
영사목장 앞,90391,2,1,2,1,0,0
영선고등학교,40853,5,1246,5,1246,0,40
영은교회,43037,57,30,57,30,0,2
영은교회,43139,8,116,8,116,0,4
영은슈퍼,89052,9,1024,9,1024,0,33
영은슈퍼,89064,1027,16,1027,16,0,33
영음교회.효성해링턴플레이스,41422,3043,543,3039,543,4,115
영종KCC스위첸.한양수자인,35449,497,3676,497,3676,0,134
영종KCC스위첸옆문,35755,1079,8992,1079,8992,0,324
영종KCC스위첸옆문,35756,8466,634,8466,634,0,293
영종LH2단지,35483,1355,1966,1355,1966,0,107
영종LH67단지,35872,906,1343,906,1343,0,72
영종LH67단지,35873,2011,947,2011,947,0,95
영종LH아파트입구,35390,259,84,259,84,0,11
영종e편한세상센텀베뉴·센트럴푸르지오자이,35660,6285,4033,6285,4033,0,332
영종e편한세상센텀베뉴·화성파크드림2차,35886,4376,4680,4376,4680,0,292
영종고등학교,35493,3049,4048,3049,4048,0,228
영종고등학교,35496,2585,2744,2585,2744,0,171
영종공원묘지입구,35626,1,27,1,27,0,0
영종공원묘지입구,35627,10,6,10,6,0,0
영종교회,35306,292,314,292,314,0,19
영종교회,35545,1015,768,1015,768,0,57
영종국제병원,35881,632,2591,632,2591,0,103
영종대교휴게소,42942,4,47,4,47,0,1
영종대교휴게소,42943,44,11,44,11,0,1
영종동행정복지센터,35672,200,247,200,247,0,14
영종동행정복지센터,35673,120,50,116,50,4,5
영종물류고등학교·영종자이아파트,35314,4676,4221,4675,4221,1,287
영종물류고등학교앞·영종자이아파트,35307,6257,4188,6254,4188,3,336
영종버스공영차고지,35837,32,1,32,1,0,1
영종버스공영차고지,35838,15,121,15,121,0,4
영종블루오션,35819,196,204,196,204,0,12
영종블루오션,35820,95,177,95,177,0,8
영종블루오션2차,35876,2654,1879,2654,1879,0,146
영종블루오션2차,35877,2241,3183,2241,3183,0,174
영종선착장입구,35833,2318,1978,2312,1978,6,138
영종선착장입구,35834,13,559,12,559,1,18
영종성당.정도사,35850,13,99,12,99,1,3
영종성당.정도사,35851,15,28,15,28,0,1
영종센트럴푸르지오자이·e편한세상센텀베뉴,35661,6177,5203,6177,5203,0,367
영종소방서,35765,8,64,8,64,0,2
영종아레나,35830,118,2,118,2,0,3
영종아레나,35831,0,196,0,196,0,6
영종역,35566,45425,1444,45407,1444,18,1511
영종역,35567,4479,13706,4466,13706,13,586
영종역(2번출구),35870,36,2266,34,2266,2,74
영종역(청라행),35620,52,13642,52,13642,0,441
영종역사관,35624,222,184,222,184,0,13
영종역사관,35625,92,211,92,211,0,9
영종유승한내들스카이스테이,35759,2363,826,2363,826,0,102
영종유승한내들스카이스테이,35760,1190,1649,1190,1649,0,91
영종자이아파트,35835,24,141,24,141,0,5
영종자이아파트,35836,399,86,399,86,0,15
영종장로교회,35580,54,116,54,116,0,5
영종장로교회,35581,85,70,84,70,1,5
영종주공7단지,35111,1273,1722,1273,1722,0,96
영종주야간보호센터,35854,7,8,7,8,0,0
영종주야간보호센터,35855,3,3,3,3,0,0
영종중학교,35463,2104,3606,2104,3606,0,184
영종중학교,35464,6034,1581,6033,1581,1,245
영종진공원,35276,1079,508,1079,508,0,51
영종진공원,35279,180,1517,180,1517,0,54
영종풍림아이원1차,35110,83,205,83,205,0,9
영종하늘도서관,35585,1592,893,1592,893,0,80
영종하늘도서관,35586,994,1090,993,1090,1,67
영종화성파크드림2차·e편한세상센텀베뉴,35885,3899,3246,3899,3246,0,230
영종힐스테이트(904동),35880,585,1310,585,1310,0,61
영진아파트,40551,102,521,102,521,0,20
영창한의원,40452,7547,6354,7547,6354,0,448
영풍아파트,36040,9704,2886,9680,2886,24,406
영풍아파트,39546,29,356,28,356,1,12
영흥감리교회입구,44201,46,16,46,16,0,2
영흥공립어린이집,44205,1,0,1,0,0,0
영흥대교입구,44100,0,2,0,2,0,0
영흥대교입구,44180,1,0,1,0,0,0
영흥면사무소,44131,1,13,1,13,0,0
영흥면사무소,44181,5,0,5,0,0,0
영흥버스터미널,44004,4252,3716,4252,3716,0,257
영흥버스터미널,44116,194,27,177,27,17,7
영흥빌라,44182,7,0,7,0,0,0
영흥수협공판장입구,44009,426,9,426,9,0,14
영흥수협공판장입구,44010,2,684,2,684,0,22
영흥어린이집,44137,10,21,10,21,0,1
영흥우체국,44107,14,16,11,16,3,0
영흥우체국,44183,25,15,25,15,0,1
영흥종합운동장앞,44120,12,26,12,26,0,1
영흥종합운동장앞,44192,26,0,26,0,0,0
영흥초교입구,44101,18,0,18,0,0,0
영흥초교입구,44184,2,24,2,24,0,0
영흥칼국수,44136,0,4,0,4,0,0
영흥플로레도커피,44144,1,8,1,8,0,0
영흥플로레도커피,44185,0,1,0,1,0,0
예단포,35319,100,257,99,257,1,11
예단포,35395,250,108,250,108,0,11
예단포물양장,35622,223,8,222,8,1,7
예단포물양장,35623,22,199,21,199,1,7
예드림빌라입구,35546,45,18,44,18,1,2
예드림빌라입구,35547,21,77,21,77,0,3
예림임업,39053,31,462,31,462,0,15
예림임업,39054,283,105,283,105,0,12
예비군교육장,41272,822,1635,822,1635,0,79
예비군교육장,41273,2396,2968,2396,2968,0,173
예비군교육장입구,90010,21,3,21,3,0,0
예비군교육장입구,90011,1,27,1,27,0,0
예비군훈련장,43201,180,10,180,10,0,6
예비군훈련장,43315,34,170,34,170,0,6
예송중학교,38592,2317,1685,2316,1685,1,129
예송중학교,38593,2261,2828,2236,2828,25,164
예술회관사거리,37254,3180,6401,3138,6401,42,309
예술회관역,39206,3513,10678,3513,10678,0,457
예술회관역(4번출구),39207,5343,5530,5343,5530,0,350
예원앞,41499,64,136,64,136,0,6
예원앞,41515,53,1,53,1,0,1
옐림교회,40854,5790,5231,5790,5231,0,355
옐림교회앞,35684,23,27,23,27,0,1
옐림교회앞,35694,39,48,39,48,0,2
오공본드,39108,4459,3081,4459,3081,0,243
오관물입구,35859,2,2,2,2,0,0
오관물입구,35860,6,2,6,2,0,0
오두돈대,43361,91,5,87,5,4,3
오두돈대,43536,7,48,6,48,1,1
오두리(넙성입구),43638,13,22,13,22,0,1
오두리(넙성입구),43675,11,59,11,59,0,2
오두리종점,43137,108,15,108,15,0,3
오두리종점,43529,5,60,5,60,0,2
오두마을입구,43557,4,0,4,0,0,0
오두마을입구,43647,0,10,0,10,0,0
오라니마을,80360,80,123,80,123,0,6
오류골,43013,217,75,217,75,0,9
오류골,43014,61,218,60,218,1,9
오류내,43389,17,410,17,410,0,13
오류내,43757,392,26,391,26,1,13
오류동마을,41353,1310,764,1310,764,0,66
오류동마을,41354,924,2599,924,2599,0,113
오류동역입구,89058,4,45,4,45,0,1
오류동역입구,89066,51,345,51,345,0,12
오리정,80125,994,126,994,126,0,36
오리정,80126,167,818,167,818,0,31
오상리고인들,43265,29,13,29,13,0,1
오상리고인들,43379,7,18,7,18,0,0
오상입구,43119,18,19,17,19,1,1
오상입구,43120,1,22,1,22,0,0
오상입구,43390,1,73,0,73,1,2
오상입구,43565,50,1,49,1,1,1
오성교회,43555,18,0,18,0,0,0
오성교회,43853,2,21,2,21,0,0
오성아파트,40480,6454,1906,6429,1906,25,269
오성아파트,40487,1654,4724,1645,4724,9,205
오성아파트,40493,669,1930,669,1930,0,83
오성아파트,40721,168,535,167,535,1,22
오성정밀,39490,426,710,426,710,0,36
오이도역,70031,825,5475,825,5475,0,203
오이도역,70032,5144,828,5144,828,0,192
오정휴먼시아(중),57044,432,2774,432,2774,0,103
오정휴먼시아(중),57045,2875,326,2875,326,0,103
오조산공원,41246,1708,1157,1708,1157,0,92
오조산공원,41249,3526,3012,3504,3012,22,210
오조산공원,41621,12,391,11,391,1,13
옥골.옥토끼우주센터,43033,152,218,152,218,0,11
옥골.옥토끼우주센터,43561,98,54,98,54,0,4
옥골사거리,38731,576,3800,576,3800,0,141
옥골사거리,38732,322,222,321,222,1,17
옥금말,43952,117,14,93,14,24,4
옥금말,43953,9,81,9,81,0,2
옥련1동행정복지센터,38217,8685,4874,8682,4874,3,437
옥련2동행정복지센터(옥련우체국),38450,2417,190,2417,190,0,84
옥련2동행정복지센터(옥련우체국),38451,523,1873,523,1873,0,77
옥련고개,38212,1579,3637,1577,3637,2,168
옥련고개,38219,1400,1254,1396,1254,4,85
옥련동성당,38330,962,2227,962,2227,0,102
옥련사거리,38170,947,1246,947,1246,0,70
옥련사거리,38171,1968,2278,1967,2278,1,136
옥련여고입구,38271,523,450,523,450,0,31
옥련여고입구,38273,560,2817,550,2817,10,108
옥련중학교,38470,2581,4709,2555,4709,26,235
옥련지구대,38223,936,4280,936,4280,0,168
옥련초등학교,38146,3792,4775,3792,4775,0,276
옥림교회,43202,44,2,42,2,2,1
옥림교회,43716,5,59,5,59,0,2
옥림슈퍼,43205,265,6,265,6,0,8
옥림슈퍼,43720,10,91,9,91,1,3
옥림에덴,90418,6,112,6,112,0,3
옥림에덴,90419,17,2,17,2,0,0
온누리병원,42425,191,860,189,860,2,33
온수교차로,90231,5,78,5,78,0,2
온수리,43018,3886,1806,3875,1806,11,183
온수리,43020,2694,2865,2676,2865,18,179
온수시장,43019,61,37,59,37,2,3
온수시장,43095,37,188,37,188,0,7
올리브백화점,39359,3164,1635,3145,1635,19,154
올리브백화점,39363,1766,1847,1756,1847,10,116
올리브백화점,39364,13829,13531,13829,13531,0,882
올리브백화점,39589,16112,18098,16110,18098,2,1103
올리브백화점,39746,13909,18129,13891,18129,18,1033
올리브백화점,39747,22275,24809,22222,24809,53,1518
올림픽공원,39209,3071,4010,3055,4010,16,228
올림픽공원,39210,319,710,319,710,0,33
올림픽생활기념관,39349,5257,5880,5249,5880,8,359
옹장골,43171,5,54,5,54,0,1
옹장골,43230,106,5,106,5,0,3
옹진군청,37019,1313,2296,1313,2296,0,116
옹진군청,37020,8482,1098,8480,1098,2,309
완정공단입구,42409,5353,3484,5353,3484,0,285
완정사거리,42561,30653,8039,30653,8039,0,1248
완정사거리,42562,193,2104,193,2104,0,74
완정역,42673,12158,40694,12157,40694,1,1704
완정역,42674,9946,23372,9945,23372,1,1074
완정초등학교.검단도서관,42414,3435,5607,3435,5607,0,291
완정초등학교.검단도서관,42415,3599,5237,3596,5237,3,285
왕궁가든,41289,2299,2733,2296,2733,3,162
왕궁가든,41291,2253,3591,2248,3591,5,188
왕길고가,42551,729,15,729,15,0,24
왕길고가,42552,8,719,8,719,0,23
왕길동,42386,21,386,19,386,2,13
왕길동,42387,212,212,209,212,3,13
왕길동(기점),42699,583,31,583,31,0,19
왕길동종점,42594,8,327,8,327,0,10
왕리물,90098,1,6,1,6,0,0
왕리물,90099,1,0,1,0,0,0
왕산골,35490,91,260,90,260,1,11
왕산골,35491,201,54,201,54,0,8
왕산교,35632,81,65,81,65,0,4
왕산교,35633,11,135,11,135,0,4
왕산차고지,35403,1005,395,1005,395,0,45
왕산차고지,35720,182,51,179,51,3,7
왕산해수욕장(왕산요트경기장),35020,1049,207,1049,207,0,40
왕산해수욕장(왕산요트경기장),35021,297,1000,295,1000,2,41
외1리마을회관앞,44096,16,27,15,27,1,1
외1리마을회관앞,44186,4,0,3,0,1,0
외1리소장골,44133,47,43,45,43,2,2
외뜰,43687,8,4,8,4,0,0
외뜰,43745,3,13,3,13,0,0
외리보건지소앞,44095,10,8,8,8,2,0
외주,43181,93,4,92,4,1,3
외주,43241,1,103,1,103,0,3
외포1리,43283,7,97,7,97,0,3
외포고개,43244,25,84,24,84,1,3
외포고개,43366,4,83,3,83,1,2
외포리,43556,1148,1364,1126,1364,22,81
외포리(싱싱마트),90376,46,10,44,10,2,1
외포리(하나로마트),90387,4,182,4,182,0,6
외포리(하나로마트),90388,112,30,112,30,0,4
외포리소공원,90127,13,14,12,14,1,0
외포리소공원,90128,2,36,2,36,0,1
외포리정미소,43240,117,3,115,3,2,3
외포삼거리,43110,292,105,286,105,6,12
외포삼거리,43285,3,132,3,132,0,4
요곡,43655,140,165,133,165,7,9
요곡,43762,109,40,109,40,0,4
요골,43590,56,0,55,0,1,1
요골,43780,1,8,1,8,0,0
용갈비,40338,88,2703,88,2703,0,90
용구물길,90385,0,56,0,56,0,1
용구물길,90386,7,0,6,0,1,0
용궁사입구,35578,345,1039,344,1039,1,44
용궁사입구,35579,978,137,973,137,5,35
용남시장,37232,17117,13964,17085,13964,32,1002
용남시장,37236,17022,18651,17003,18651,19,1150
용남파출소,37177,7854,2689,7850,2689,4,340
용남파출소,37184,4430,11221,4425,11221,5,504
용담공원,38172,1404,2262,1404,2262,0,118
용담공원,38177,2607,1522,2607,1522,0,133
용담마을,38191,4646,5935,4646,5935,0,341
용담마을,38192,5375,3160,5375,3160,0,275
용담어촌계앞,44097,22,5,20,5,2,0
용담어촌계앞,44189,3,1,3,1,0,0
용당사터,43537,115,8,109,8,6,3
용당사터,43677,4,61,4,61,0,2
용유동행정복지센터,35017,95,33,95,33,0,4
용유동행정복지센터,35211,45,142,45,142,0,6
용유동행정복지센터,35411,195,314,194,314,1,16
용유동행정복지센터,35412,343,115,343,115,0,14
용유역,35433,236,1156,236,1156,0,44
용유초등학교,35022,288,43,288,43,0,10
용유초등학교,35023,41,348,41,348,0,12
용유초등학교,35409,95,578,95,578,0,21
용유초등학교삼거리,35410,450,43,450,43,0,15
용일사거리,37208,28748,21707,28726,21707,22,1627
용일사거리,37218,27008,28636,26960,28636,48,1794
용일사거리,37251,1040,1293,1040,1293,0,75
용일초등학교,37233,12827,8086,12815,8086,12,674
용일초등학교,37237,7327,16097,7310,16097,17,755
용정리 사거리,43721,1,184,1,184,0,5
용정마을회관,43370,0,59,0,59,0,1
용정마을회관,43615,361,2,349,2,12,11
용정초등학교,37297,1251,725,1251,725,0,63
용정초등학교,37299,729,1848,729,1848,0,83
용진주택,43084,266,73,264,73,2,10
용진주택,43085,15,40,15,40,0,1
용진진,43639,3,45,3,45,0,1
용진진,43678,37,4,37,4,0,1
용현2동행정복지센터,37653,1642,292,1642,292,0,62
용현2동행정복지센터,37654,331,2053,331,2053,0,76
용현3동행정복지센터.보훈병원,37221,24393,16681,24311,16681,82,1324
용현3동행정복지센터.보훈병원,37224,12167,15671,12152,15671,15,898
용현5동행정복지센터,37129,283,905,283,905,0,38
용현고가교,37550,213,2298,213,2298,0,81
용현고가교,37611,13493,1414,13490,1414,3,480
용현고개,37178,7171,8545,7166,8545,5,506
용현고개,37497,9290,7624,9286,7624,4,545
용현동농협,37117,470,2874,470,2874,0,107
용현동상우빌라,37564,9,646,5,646,4,21
용현동상우빌라,37565,690,97,685,97,5,25
용현동성원상떼빌아파트,37546,474,659,474,659,0,36
용현사거리,37212,2831,1859,2825,1859,6,151
용현사거리,37213,1576,4249,1566,4249,10,187
용현시장,37227,23162,28380,23149,28380,13,1662
용현시장,37230,24844,16261,24827,16261,17,1325
용현시장,37268,5840,3678,5818,3678,22,307
용현시장,37270,4348,5647,4305,5647,43,322
용현아파트,37153,20,347,20,347,0,11
용현중학교,37021,3282,624,3273,624,9,126
용현중학교,37028,1054,2425,1052,2425,2,112
용현초등학교,37508,3,831,3,831,0,26
용현초등학교입구,37128,10303,3991,10262,3991,41,461
용현초등학교입구,37134,6743,13774,6716,13774,27,661
용화사(길상낚시터),90077,13,53,13,53,0,2
용화사(길상낚시터),90080,49,61,49,61,0,3
우뢰촌,43425,119,44,116,44,3,5
우뢰촌,43792,119,87,117,87,2,6
우리자동차,35223,780,201,712,201,68,31
우림라이온스밸리,40592,294,4760,292,4760,2,163
우림라이온스밸리,40594,8259,1233,8248,1233,11,306
우림필유아파트,42924,3389,1460,3387,1460,2,156
우림필유아파트,42925,1141,2782,1140,2782,1,126
우물골,43929,71,55,71,55,0,4
우물골,43930,23,62,23,62,0,2
우미린1단지정문,35583,2910,845,2910,845,0,121
우미린1단지정문,35584,1325,2841,1325,2841,0,134
우미린1단지후문,35461,1936,5294,1936,5294,0,233
우미린1단지후문,35462,6136,1214,6136,1214,0,237
우미린2단지정문,35512,4946,1304,4944,1304,2,201
우미린2단지정문,35513,1918,5535,1917,5535,1,240
우미린2단지후문,35454,3327,1181,3327,1181,0,145
우미린더시그니처(후문),89443,2891,294,2891,294,0,102
우성1차아파트,38094,4622,4750,4621,4750,1,302
우성1차아파트,39834,551,15,551,15,0,18
우성2차아파트(옥련동),38356,2907,890,2907,890,0,122
우성2차아파트·원인재역(4번출구),38150,3092,7251,3090,7251,2,333
우성4차,40185,6121,219,6121,219,0,204
우성4차,40187,160,5712,160,5712,0,189
우성4차후문,40730,181,2418,181,2418,0,83
우성4차후문,40731,2828,178,2828,178,0,96
우성아파트,38143,4730,2354,4730,2354,0,228
우성아파트,38357,1069,2502,1069,2502,0,115
우성아파트,40341,940,1669,938,1669,2,84
우성아파트,42717,4463,6592,4463,6592,0,356
우성아파트,42718,3110,3445,3110,3445,0,211
우성아파트.은행교회,70026,451,34,451,34,0,15
우저서원(대성주유소),35214,86,98,86,98,0,5
우저서원(대성주유소),35215,77,734,77,734,0,26
우정아파트,37675,205,310,205,310,0,16
우주골드타운빌라,40863,736,1224,736,1224,0,63
우주골드타운빌라,40864,354,1080,354,1080,0,46
우주아파트,38252,7053,8512,7053,8512,0,502
우진기계,89106,25,297,25,297,0,10
우진아파트,37158,2216,2442,2216,2442,0,150
우진아파트,37159,564,3087,564,3087,0,117
우체국사거리,39694,1039,1865,1039,1865,0,93
우체국사거리,39695,1793,899,1793,899,0,86
우체국사거리,39704,2483,2224,2483,2224,0,151
욱일아파트후문,40877,1621,2319,1621,2319,0,127
운남교차로,35435,55,120,55,120,0,5
운남교차로,35444,163,138,163,138,0,9
운남교차로,35524,113,43,113,43,0,5
운남교차로,35582,42,33,42,33,0,2
운남교차로 입구,35839,17,74,16,74,1,2
운남교차로 입구,35840,22,26,22,26,0,1
운남교차로.잔다리,35595,503,373,503,373,0,28
운남교차로.잔다리,35596,302,560,302,560,0,27
운남동,35268,323,303,323,303,0,20
운남동,35281,330,265,330,265,0,19
운남동우체국,35848,393,197,393,197,0,19
운남동우체국,35849,264,497,264,497,0,24
운남초교사거리,35706,42,174,42,174,0,6
운남초교사거리,35707,415,201,415,201,0,19
운북공영차고지,35779,412,2,412,2,0,13
운북공영차고지,35783,1,538,1,538,0,17
운서2차SKVIEW스카이시티,35882,3738,1296,3737,1296,1,162
운서2차SKVIEW스카이시티,35883,1844,3458,1844,3458,0,171
운서SKVIEW 스카이시티,35780,68,133,68,133,0,6
운서SKVIEW·세계로향하는교회,35781,146,265,146,265,0,13
운서역,35242,29589,15424,29584,15424,5,1452
운서역,35257,8296,17785,8296,17785,0,841
운서역(남동측),35775,523,920,523,920,0,46
운서역(남동측),35776,1118,1030,1118,1030,0,69
운서역(하워드존슨호텔),35747,5347,5066,5347,5066,0,335
운서역금강펜테리움아파트,35482,2255,1095,2255,1095,0,108
운서역반도유보라,35878,2847,2611,2847,2611,0,176
운서역반도유보라,35879,2156,1738,2156,1738,0,125
운서초등학교,35270,7192,2497,7192,2497,0,312
운서초등학교,35282,2656,4453,2656,4453,0,229
운양역,80348,170,576,170,576,0,24
운양역,80351,291,120,291,120,0,13
운연동,39374,632,755,632,755,0,44
운연동,39379,585,607,585,607,0,38
운연동,39673,31,0,31,0,0,1
운연삼거리,39987,811,1651,811,1651,0,79
운연삼거리,39988,62,679,62,679,0,23
운연역,39954,10559,11555,10559,11555,0,713
운연역,92026,6387,6823,6387,6823,0,426
운연천,92027,334,987,334,987,0,42
운연천,92028,553,269,553,269,0,26
운전면허시험장,39005,2113,963,2113,963,0,99
울레기,43179,12,271,12,271,0,9
울레기,43548,282,16,275,16,7,9
웃말,90169,4,5,4,5,0,0
웃말,90170,13,9,13,9,0,0
원당고등학교,42459,3016,3295,3013,3295,3,203
원당교,89485,317,131,317,131,0,14
원당교,89486,61,1605,61,1605,0,53
원당사거리.검단선사박물관,42446,18773,8773,18768,8773,5,888
원당사거리.검단선사박물관,42447,11628,18524,11626,18524,2,972
원당중고등학교,42460,51,263,51,263,0,10
원당중고등학교,42462,185,240,185,240,0,13
원동초등학교,39656,1965,7393,1958,7393,7,301
원동초등학교,39657,9779,1979,9766,1979,13,379
원성골,35434,86,179,85,179,1,8
원성골,35445,94,261,94,261,0,11
원수리마을,90251,1,3,1,3,0,0
원수리마을,90252,5,2,5,2,0,0
원인재역(1번출구),38162,1895,7106,1892,7106,3,290
원인재역(4번출구),38153,10413,2994,10400,2994,13,432
원인재역(6번출구),38166,7071,2553,7071,2553,0,310
원적산터널,40821,1688,3261,1688,3261,0,159
원적산터널,40822,2091,3252,2091,3252,0,172
원적산터널서측,42666,4915,3854,4915,3854,0,282
원적산터널서측,42667,3770,3527,3769,3527,1,235
원종IC(중),57046,70,2870,70,2870,0,94
원종IC(중),57047,999,72,999,72,0,34
원진운수차고지,89003,819,109,819,109,0,29
원진운수차고지,89004,78,944,73,944,5,32
원창동(기점),89143,694,67,691,67,3,24
원창동(기점),89144,28,2887,28,2887,0,94
원창동(종점),42183,14,1042,10,1042,4,34
원창동(종점),42184,780,194,723,194,57,31
원창동차고지,89515,72,1,35,1,37,2
원창로89번길,89505,1851,21,1851,21,0,60
원흥아파트,38131,23475,15102,23431,15102,44,1244
원흥아파트,38336,32935,22784,32890,22784,45,1797
원흥아파트,42793,55,1,55,1,0,1
월곳삼거리,43188,0,67,0,67,0,2
월곳삼거리,43619,66,0,64,0,2,2
월곶동주민센터.월곶포구,70006,747,204,746,204,1,30
월곶동주민센터.월곶포구,70005,260,1546,259,1546,1,58
월곶어울림센터,25095,136,105,127,105,9,7
월드메르디앙아파트,42161,4061,4597,4055,4597,6,279
월드메르디앙아파트,42163,5810,3481,5799,3481,11,299
월드아파트,42499,7433,10271,7427,10271,6,571
월드아파트,42500,12223,6215,12218,6215,5,594
월미공원,35138,51,819,51,819,0,28
월미공원,35572,150,23,150,23,0,5
월미공원역,35345,119,3185,119,3185,0,106
월미공원역,35346,4433,209,4431,209,2,149
월미도,35148,31951,213,31879,213,72,1037
월미도(시티투어),35144,973,14919,959,14919,14,512
월미도기점,35897,101,36,96,36,5,4
월미도문화관,35558,1797,44,1785,44,12,59
월미도종점,35368,121,7038,121,7038,0,230
월미문화의거리,35132,15,3914,15,3914,0,126
월미문화의거리,35219,3300,20,3300,20,0,107
월미테마파크,35128,77,11275,77,11275,0,366
월미테마파크,35502,5374,62,5374,62,0,175
월선포,90040,0,6,0,6,0,0
월선포,90041,86,186,81,186,5,8
웨딩타운,22061,184,1,184,1,0,5
웨딩타운,23077,0,34,0,34,0,1
웰카운티,38352,1680,5374,1680,5374,0,227
웰카운티,38353,10951,1799,10951,1799,0,411
웰카운티,42772,1590,4307,1590,4307,0,190
웰카운티17단지,89182,3276,401,3276,401,0,118
웰카운티17단지,89183,571,2890,571,2890,0,111
웰카운티1단지,38648,977,3472,977,3472,0,143
웰카운티1차,42746,1971,1515,1971,1515,0,112
웰카운티1차,42764,2239,1361,2239,1361,0,116
웰카운티2단지,38709,780,666,778,666,2,46
웰카운티4단지,38446,671,343,669,343,2,32
웰카운티4단지,38447,241,1425,241,1425,0,53
윗말,43488,7,1,7,1,0,0
윗말,43839,0,2,0,2,0,0
윗망월,43335,0,102,0,102,0,3
윗망월,43578,133,1,117,1,16,4
유니온프라자,42113,12789,7622,12750,7622,39,658
유림골프장,41469,1,940,1,940,0,30
유림골프장,41667,737,13,737,13,0,24
유성아파트,43086,135,832,134,832,1,31
유성아파트,43087,798,68,797,68,1,27
유수지,39010,649,819,649,819,0,47
유수지,39011,746,1991,746,1991,0,88
유수지근린공원,39019,1054,842,1054,842,0,61
유수지근린공원,39020,655,889,655,889,0,49
유수지길,39003,1282,2150,1282,2150,0,110
유수지길,39004,1577,1095,1577,1095,0,86
유승아파트,42397,2796,445,2796,445,0,104
유승아파트,42398,440,2605,440,2605,0,98
유승아파트(삼성홈타운아파트),41003,3806,3077,3802,3077,4,222
유승아파트(삼성홈타운아파트),41004,3193,3439,3187,3439,6,213
유승아파트(삼성홈타운아파트),41005,6625,2064,6617,2064,8,280
유승아파트(삼성홈타운아파트),41006,1513,6568,1509,6568,4,260
유승아파트(삼성홈타운아파트),41583,0,281,0,281,0,9
유승한내들에듀파크,89520,926,1275,926,1275,0,71
유원아파트,37163,5752,10324,5714,10324,38,518
유원아파트,37172,12184,4556,12155,4556,29,540
유진시스템앞,40676,854,4235,854,4235,0,164
유진시스템앞,40678,1689,929,1689,929,0,84
유진투자증권.파이낸셜뉴스신문,19283,1003,32,1003,32,0,33
유천아파트,38254,979,824,979,824,0,58
유천아파트,38266,7728,5503,7728,5503,0,426
유천아파트후문,38265,428,1026,428,1026,0,46
유현마을.신동아아파트,80001,151,349,151,349,0,16
유현마을.신동아아파트,80073,346,39,346,39,0,12
유현사거리,42484,6938,12898,6938,12898,0,639
유현사거리,42487,7801,5909,7801,5909,0,442
유호엔시티.논현푸르지오,39823,35,1963,32,1963,3,64
육골,18805,3,97,3,97,0,3
육골,62030,0,3,0,3,0,0
윤성아파트,38307,228,1551,226,1551,2,57
윤성아파트(인항고교),37011,2344,3946,2344,3946,0,202
윤성아파트(인항고교),37012,3985,1878,3984,1878,1,189
율도근린공원,89339,339,99,339,99,0,14
율도근린공원,89340,301,533,301,533,0,26
율도근린공원입구,89428,125,219,125,219,0,11
율도근린공원입구,89429,169,121,169,121,0,9
율도입구,42188,1799,1057,1799,1057,0,92
율도입구,42190,862,1320,862,1320,0,70
율목동행정복지센터,35787,30,107,30,107,0,4
율목동행정복지센터,35801,89,12,89,12,0,3
율목오거리,35786,29,63,29,63,0,2
율목오거리,35802,113,30,113,30,0,4
율생리입구,80016,206,1174,206,1174,0,44
율생리입구,80017,1192,184,1190,184,2,44
은계초등학교.사랑스러운교회,70025,1452,30,1452,30,0,47
은골공원,35599,1519,2633,1517,2633,2,133
은골공원,35600,2203,2575,2202,2575,1,154
은골사거리,35309,228,216,228,216,0,14
은당골,90212,16,11,15,11,1,0
은당골,90213,17,11,17,11,0,0
은봉초등학교,39613,12129,2773,12099,2773,30,480
은봉초등학교,39614,2830,12795,2828,12795,2,504
은성아파트,39321,6913,3347,6895,3347,18,330
은성프레미오,39325,1822,4793,1806,4793,16,213
은영빌라,41089,2208,124,2208,124,0,75
은영아파트,42218,3860,3026,3859,3026,1,222
은지초등학교사거리,42365,5166,5860,5164,5860,2,355
은하마을.중흥마을,55069,385,1361,385,1361,0,56
은하목장앞,43274,3,4,3,4,0,0
은하목장앞,43852,0,14,0,14,0,0
은하쌍용아파트,55062,1213,5040,1213,5040,0,201
은행마을,41198,7966,3107,7956,3107,10,357
은행초등학교,70019,3450,552,3450,552,0,129
을왕리해수욕장,35009,5166,664,5163,664,3,188
을왕리해수욕장,35010,1422,5866,1414,5866,8,235
을왕리해수욕장.더위크앤리조트,35015,2778,610,2777,610,1,109
을왕리해수욕장.더위크앤리조트,35016,863,2570,862,2570,1,110
읍내리마을회관입구,90032,1,25,1,25,0,0
읍내리마을회관입구,90033,29,0,28,0,1,0
응곡,43696,32,36,30,36,2,2
응곡,43749,38,24,35,24,3,2
이강리방앗간,43691,90,9,88,9,2,3
이강리방앗간,43832,19,210,19,210,0,7
이건창생가,43145,74,1,72,1,2,2
이건창생가,43434,0,99,0,99,0,3
이규보묘입구,90065,136,29,136,29,0,5
이규보묘입구,90389,24,143,24,143,0,5
이대역,22015,4772,76,4772,76,0,156
이대역,22057,3093,45,3093,45,0,101
이대역,23036,95,5955,95,5955,0,195
이마트,41122,4287,17282,4286,17282,1,695
이마트,41125,25408,8785,25381,8785,27,1103
이마트송림점,36098,5166,7142,5162,7142,4,397
이마트송림점,36100,7240,4623,7230,4623,10,382
이안송도,38409,24547,7127,24547,7127,0,1021
이영화학,39644,2354,923,2354,923,0,105
이음1로.모아미래도엘리트파크,89514,1344,1192,1344,1192,0,81
이음1로.예미지더시그너스,89513,3395,1886,3395,1886,0,170
이음2로.디에트르더펠리체,89509,1301,122,1301,122,0,45
이음2로.파라곤센트럴파크,89510,169,1576,169,1576,0,56
이음5로.금호어울림센트럴,89433,1233,5834,1233,5834,0,227
이음5로.우미린더시그니처,89432,4892,2227,4892,2227,0,229
이음대로.대성베르힐,89440,17585,2474,17573,2474,12,647
이음대로.대성베르힐,89441,3129,26085,3129,26085,0,942
이음대로.디에트르더펠리체,89438,8873,1954,8873,1954,0,349
이음대로.호반써밋,89439,3616,12361,3611,12361,5,515
이촌,43312,0,2,0,2,0,0
이촌,43768,9,1,9,1,0,0
이토상가,39196,7973,1994,7973,1994,0,321
이현(이강리교회),43661,8,179,8,179,0,6
이현(이강리교회),43690,208,12,203,12,5,7
이화1동입구,41487,133,115,133,115,0,8
이화1동입구,41506,46,0,46,0,0,1
이화2동마을회관,41484,12,33,12,33,0,1
이화2동마을회관,41504,81,72,81,72,0,4
이화2동회차지,41486,3,8,3,8,0,0
이화교회앞,41489,49,23,49,23,0,2
이화동노인정,41490,68,26,64,26,4,3
이화동다리,41479,37,215,37,215,0,8
이화동다리,41516,526,16,526,16,0,17
이화진등마을경로당,41601,41,71,41,71,0,3
인고앞,37318,3111,6266,3111,6266,0,302
인고앞,37338,6817,3989,6809,3989,8,348
인고체육관,37305,9431,4963,9431,4963,0,464
인고체육관(동양장사거리),37309,6238,6892,6232,6892,6,423
인내마을,90181,8,32,8,32,0,1
인내마을,90182,13,0,13,0,0,0
인명여자고등학교,37199,33593,4430,33593,4430,0,1226
인명여자고등학교,37205,9248,43652,9248,43652,0,1706
인사리군부대앞,90268,13,41,13,41,0,1
인사리군부대앞,90270,24,0,24,0,0,0
인사리마을회관,90267,3,10,3,10,0,0
인사리마을회관,90271,13,0,13,0,0,0
인사리우무렛골,90266,4,44,4,44,0,1
인사리인현경로당앞,90269,45,35,45,35,0,2
인사리지석교회,90272,1,11,1,11,0,0
인산저수지,43354,114,60,113,60,1,5
인산저수지,43575,76,108,75,108,1,5
인삼농협앞,80305,13,270,13,270,0,9
인삼농협앞,80306,339,11,339,11,0,11
인성여자고등학교,35793,128,777,128,777,0,29
인성여자고등학교,35808,20,417,20,417,0,14
인송빌라,40241,2747,16,2747,16,0,89
인수초등학교,39386,10342,9911,10342,9911,0,653
인수초등학교,39392,13901,12603,13901,12603,0,854
인썸호텔,44134,14,19,12,19,2,1
인아교회,35091,1243,174,1243,174,0,45
인아교회,35094,215,1044,215,1044,0,40
인재개발원,42281,1385,2381,1384,2381,1,121
인재개발원,42282,2252,1387,2251,1387,1,117
인제고등학교,39548,451,1439,440,1439,11,60
인천가정법원.인천지방법원등기국,37405,9902,12795,9888,12795,14,732
인천가정법원.인천지방법원등기국,37409,23877,21424,23831,21424,46,1461
인천가족공원입구,39493,638,538,638,538,0,37
인천가족공원입구,39495,886,1800,885,1800,1,86
인천가족공원입구,92059,1785,1254,1780,1254,5,98
인천가톨릭대학교,39931,3089,2177,3089,2177,0,169
인천가톨릭대학교(카펠라관),38778,102,11,102,11,0,3
인천경로당앞,90226,15,20,15,20,0,1
인천경로당앞,90227,10,16,9,16,1,0
인천경연초중학교,89347,76,301,76,301,0,12
인천공항T1(1층13B),35205,39308,325,39308,325,0,1278
인천공항T1(1층2A),35344,47565,2838,47565,2838,0,1625
인천공항T1(1층2B),35202,25105,5167,25105,5167,0,976
인천공항T1(3층13번),35556,2118,19736,2118,19736,0,704
인천공항T1(3층14번),35753,3668,6832,3668,6832,0,338
인천공항T1(3층2번),35032,3723,46795,3723,46795,0,1629
인천공항T1(3층6번),35752,9865,19876,9865,19876,0,959
인천공항T1(3층7번),35203,11264,52652,11262,52652,2,2061
인천공항T1-3층,35325,10,22,10,22,0,1
인천공항T1장기주차장,35895,131,0,131,0,0,4
인천공항T1장기주차장,35896,0,3,0,3,0,0
인천공항T2(1)A(1층),35618,18869,49,18869,49,0,610
인천공항T2(1)번출입구(3층),35614,6436,30553,6436,30553,0,1193
인천공항T2(6)B(1층),35619,4595,204,4595,204,0,154
인천공항T2(8)번출입구(3층),35615,9226,7338,9226,7338,0,534
인천공항T2-3층,35611,47,36,47,36,0,2
인천공항T2-B1층,35612,266,1,266,1,0,8
인천공항전망대,35365,2,66,2,66,0,2
인천공항전망대,35366,56,3,56,3,0,1
인천공항전망대(미정차),35630,5,0,5,0,0,0
인천공항충전소입구,35757,10,47,10,47,0,1
인천공항충전소입구,35758,41,4,41,4,0,1
인천과학예술영재학교,38579,135,135,135,135,0,8
인천과학예술영재학교,38580,21,735,21,735,0,24
인천광역시종합건설본부,37325,7225,5971,7225,5971,0,425
인천교(인천기계산업단지),37449,1230,921,1230,921,0,69
인천교(인천기계산업단지),37451,344,1360,343,1360,1,54
인천교삼거리,37453,1781,4840,1768,4840,13,213
인천교삼거리(인천기계산업단지),37452,1490,1142,1476,1142,14,84
인천교통공사,40032,39070,33783,39014,33783,56,2350
인천교회,38676,2912,5446,2904,5446,8,269
인천교회,39260,3002,3628,2996,3628,6,213
인천교회,39261,3426,2473,3417,2473,9,190
인천국민안전체험관,42233,134,518,134,518,0,21
인천국민안전체험관,42234,1248,913,1248,913,0,69
인천국민안전체험관(북측),89516,102,344,102,344,0,14
인천국민안전체험관(북측),89517,45,400,45,400,0,14
인천국제공항,35613,25,0,25,0,0,0
인천국제수산물타운,35815,18,1323,18,1323,0,43
인천국제수산물타운,35816,702,70,692,70,10,24
인천그랜드컨트리클럽,42954,90,914,90,914,0,32
인천그랜드컨트리클럽,42958,5,25,4,25,1,0
인천글로벌캠퍼스,39850,2908,2840,2908,2840,0,185
인천글로벌캠퍼스,39858,3024,3017,3024,3017,0,194
인천기계공고,37272,17663,7280,17663,7280,0,804
인천기계공고,37281,4140,12468,4140,12468,0,535
인천기계산업단지,37579,638,19,638,19,0,21
인천기계산업단지,37580,1,680,1,680,0,21
인천기독병원,35785,226,396,226,396,0,20
인천기독병원,35803,29,124,29,124,0,4
인천나비공원,40849,4047,2511,4023,2511,24,211
인천나비공원,40926,23,1,23,1,0,0
인천남동우체국,39630,7731,7637,7727,7637,4,495
인천남부초.힐스테이트푸르지오,37275,13256,14446,13250,14446,6,893
인천논현역앞,39658,12907,17524,12904,17524,3,981
인천논현역앞,39659,15865,9751,15858,9751,7,826
인천논현중학교,92060,236,1699,236,1699,0,62
인천논현중학교,92061,393,173,388,173,5,18
인천논현중학교,92062,1159,90,1151,90,8,40
인천대검도수련원,43456,1,34,1,34,0,1
인천대검도수련원,43695,58,0,58,0,0,1
인천대공원,39471,5702,998,5702,998,0,216
인천대공원,39478,4425,8889,4425,8889,0,429
인천대공원역,39395,8316,2378,8316,2378,0,344
인천대공원역,39398,93,2276,93,2276,0,76
인천대공원후문(장수동),39442,4986,846,4986,846,0,188
인천대교TG(미정차),35629,0,1,0,1,0,0
인천대입구역,38395,64692,21581,64675,21581,17,2783
인천대입구역,38396,17756,70418,17746,70418,10,2844
인천대입구역.롯데몰,38646,6662,4880,6653,4880,9,372
인천대입구역.롯데몰,38649,3266,3215,3260,3215,6,209
인천대정문,38385,25690,754,25685,754,5,853
인천대정문,38386,1605,23934,1605,23934,0,823
인천대학교공과대학,38376,372,8413,366,8413,6,283
인천대학교공과대학,38377,26532,62,26505,62,27,857
인천대학교공과대학,38499,482,18364,438,18364,44,607
인천대학교북문,38760,9,1441,9,1441,0,46
인천대학교북문,38750,644,96,644,96,0,23
인천대학교송도캠퍼스,38749,25230,3310,25218,3310,12,920
인천대학교송도캠퍼스,38761,18,9044,18,9044,0,292
인천대학교자연과학대학,38375,210,16083,210,16083,0,525
인천대학교자연과학대학,38378,23937,158,23927,158,10,777
인천마전도서관,42556,22,1059,22,1059,0,34
인천만수고등학교,39680,2121,2645,2121,2645,0,153
인천만수고등학교,39681,3061,2576,3061,2576,0,181
인천미래생활고등학교,40470,4372,4729,4372,4729,0,293
인천미래생활고등학교,40474,5575,5308,5575,5308,0,351
인천미래생활고등학교,40483,1122,1990,1122,1990,0,100
인천미래생활고등학교,55032,2947,1434,2947,1434,0,141
인천박문초등학교,38608,366,198,366,198,0,18
인천박문초등학교,38609,127,449,127,449,0,18
인천보건고등학교,42144,2903,4898,2897,4898,6,251
인천보건고등학교,42146,5884,3919,5854,3919,30,316
인천부흥고등학교,40279,1357,611,1357,611,0,63
인천북항관공선부두,89195,73,1408,73,1408,0,47
인천북항관공선부두,89196,767,33,767,33,0,25
인천북항부두운영시설,42953,3,407,3,407,0,13
인천북항부두운영시설,42959,443,16,443,16,0,14
인천뷰티예술고등학교,38052,3369,3862,3361,3862,8,233
인천뷰티예술고등학교,38053,6734,2992,6729,2992,5,313
인천비즈니스고등학교,37421,4152,3982,4146,3982,6,262
인천비즈니스고등학교,37423,5309,5518,5301,5518,8,349
인천비즈니스고등학교,37614,8332,2429,8328,2429,4,347
인천비지니스고등학교,37615,362,2674,362,2674,0,97
인천상공회의소,92041,74,2,74,2,0,2
인천서곶초등학교,89355,647,1,647,1,0,20
인천서곶초등학교,89358,7,1281,5,1281,2,41
인천서부교육지원청,42336,980,443,980,443,0,45
인천서부교육지원청,42337,403,1559,403,1559,0,63
인천서부여성회관,42131,2194,1530,2177,1530,17,120
인천서부여성회관,42134,4077,5057,4057,5057,20,294
인천서창동우체국,39820,5348,10381,5348,10381,0,507
인천서창동우체국,39821,9331,2343,9330,2343,1,376
인천서창중학교,39767,5318,5653,5318,5653,0,353
인천서창중학교,39875,7702,3136,7702,3136,0,349
인천성모병원정문,40844,7977,8056,7958,8056,19,517
인천성모병원정문,40857,8712,6899,8705,6899,7,503
인천성모병원종점지주차장,40919,152,4594,151,4594,1,153
인천성모병원후문,40138,1873,7509,1871,7509,2,302
인천성모병원후문,40139,4620,2143,4609,2143,11,218
인천세관통합검사센터(동측),38774,8,1494,6,1494,2,48
인천세관통합검사센터(동측),38775,366,37,362,37,4,13
인천세관통합검사센터(서측),38772,364,394,364,394,0,24
인천세관통합검사센터(서측),38773,39,942,38,942,1,31
인천세무서후문,36179,37,190,37,190,0,7
인천소방본부,37189,5258,9967,5248,9967,10,491
인천소방본부,37191,13976,5750,13959,5750,17,636
인천소방항공대,35809,136,6,136,6,0,4
인천소방항공대,35810,11,254,11,254,0,8
인천송도꿈유치원,38622,5348,59,5348,59,0,174
인천송도꿈유치원,38623,8,6044,8,6044,0,195
인천송일초등학교,38558,794,1677,792,1677,2,79
인천송일초등학교,38575,1426,1879,1426,1879,0,106
인천수산물센터,35069,7794,7178,7698,7178,96,482
인천스타트업파크,38390,2289,1036,2289,1036,0,107
인천스타트업파크,38394,1193,3217,1193,3217,0,142
인천시청후문,39290,11840,9093,11830,9093,10,675
인천시청후문,39292,11003,11900,10983,11900,20,738
인천아시아드주경기장(동문),89354,1058,19,1031,19,27,34
인천아시아드주경기장(동문),89359,88,1717,88,1717,0,58
인천아시아드테니스장,89356,643,16,642,16,1,21
인천아시아드테니스장,89357,10,1068,9,1068,1,34
인천여객터미널,89155,2,184,2,184,0,6
인천여자고등학교,38287,8940,8330,8940,8330,0,557
인천여자고등학교,38289,5106,5080,5106,5080,0,328
인천여자상업고등학교,35139,323,2393,321,2393,2,87
인천여자상업고등학교·이마트,35141,8951,2621,8941,2621,10,373
인천역(차이나타운),35178,30690,23923,30674,23923,16,1761
인천역(차이나타운),35179,26130,29240,26113,29240,17,1786
인천연세병원,42310,2213,2694,2213,2694,0,158
인천연합의원,42601,2353,3740,2350,3740,3,196
인천영어마을,42454,8749,8247,8749,8247,0,548
인천영어마을,42697,10246,14985,10246,14985,0,813
인천영어마을.파라곤센트럴,89437,6785,1803,6779,1803,6,277
인천영어마을앞,89436,174,1187,154,1187,20,43
인천예림학교(인천성모병원),40819,5101,6283,5101,6283,0,367
인천예림학교(인천성모병원),40820,6855,4173,6852,4173,3,355
인천예술고등학교,39332,902,542,894,542,8,46
인천예술고등학교,39533,473,696,468,696,5,37
인천옹진농협본점,35555,7124,4297,7113,4297,11,368
인천옹진농협본점,35797,1088,1939,1080,1939,8,97
인천용학초등학교,37676,2344,23,2344,23,0,76
인천의료원,36093,515,4409,515,4409,0,158
인천의료원,36107,14938,9093,14918,9093,20,775
인천의료원,36108,9039,12119,9021,12119,18,682
인천의료원,37458,4564,796,4561,796,3,172
인천이음중학교,89456,3337,1069,3337,1069,0,142
인천이음초등학교,89399,3136,866,3136,866,0,129
인천이음초등학교,89400,3219,7929,3219,7929,0,359
인천인력개발원,39071,1728,768,1728,768,0,80
인천인력개발원,39072,608,1905,608,1905,0,81
인천적십자병원(풍림아파트),38240,3572,5095,3572,5095,0,279
인천적십자병원(풍림아파트),38339,5849,4533,5849,4533,0,334
인천정보과학고등학교,35175,2593,3885,2593,3885,0,208
인천정보과학고등학교,35183,5372,2185,5366,2185,6,243
인천정보과학고등학교,35800,8,19,8,19,0,0
인천정보과학고등학교,36002,2491,4752,2477,4752,14,233
인천종합수산물센터,35074,3510,211,3447,211,63,120
인천준법지원센터·미추홀트루엘파크,37147,896,377,896,377,0,41
인천준법지원센터·미추홀트루엘파크,37148,182,1068,182,1068,0,40
인천지방법원,37096,3950,81,3937,81,13,130
인천지방법원북부지원입구,89434,859,839,859,839,0,54
인천지방법원북부지원입구,89435,47,2109,47,2109,0,69
인천지방중소기업청입구,39087,2966,1090,2966,1090,0,130
인천체육고등학교,89233,235,258,235,258,0,15
인천체육고등학교입구,89048,18,12,18,12,0,0
인천체육고등학교입구,89049,5,44,5,44,0,1
인천축구전용경기장,36184,67,7,67,7,0,2
인천축구전용경기장,37286,2540,2797,2531,2797,9,172
인천축구전용경기장,37303,4028,1861,4016,1861,12,189
인천축구전용경기장(서희스타힐스),37558,526,2572,522,2572,4,99
인천축산농협,40454,365,918,365,918,0,41
인천축산물시장,42010,1176,1004,1176,1004,0,70
인천축산물시장,42011,801,1179,801,1179,0,63
인천출입국·외국인청,35127,14612,1768,14581,1768,31,528
인천출입국·외국인청,35129,1218,12406,1201,12406,17,439
인천터미널,37215,1891,11,1891,11,0,61
인천터미널사거리입구,39194,1247,5047,1247,5047,0,203
인천터미널역,37648,566,29,566,29,0,19
인천테크노밸리U1센터,40605,6014,7964,6012,7964,2,450
인천테크노밸리U1센터,40607,9746,5975,9743,5975,3,507
인천포스코고등학교,38758,11,959,11,959,0,31
인천포스코고등학교,38759,552,12,552,12,0,18
인천푸른빛유치원,89376,1428,107,1428,107,0,49
인천푸른빛유치원,89377,252,1440,252,1440,0,54
인천항신국제여객터미널,38652,2554,567,2551,567,3,100
인천항신국제여객터미널(하행),38662,833,1900,832,1900,1,88
인천해든초등학교,89410,4684,3148,4684,3148,0,252
인천해든초등학교,89411,4372,2828,4372,2828,0,232
인천해양과학고,38120,2058,1551,2058,1551,0,116
인천해양과학고,38566,639,743,635,743,4,44
인천향교.인천도호부청사,37124,4906,11594,4905,11594,1,532
인천향교.인천도호부청사,37125,7871,1683,7841,1683,30,308
인천향교유림회관,37059,13382,4436,13382,4436,0,574
인천향교유림회관,37062,8541,13926,8541,13926,0,724
인천환경공단입구,42930,342,84,342,84,0,13
인천힘찬종합병원,39628,5887,4155,5879,4155,8,323
인천힘찬종합병원,39629,4517,4696,4513,4696,4,297
인평자동차고,40149,16702,20938,16702,20938,0,1214
인평자동차고,40151,1247,812,1247,812,0,66
인평자동차고,40152,507,1116,507,1116,0,52
인평자동차고,40787,21009,13208,21006,13208,3,1103
인하국제의료센터,35643,0,11,0,11,0,0
인하대병원,35119,10582,7701,10530,7701,52,589
인하대병원,35121,3784,1699,3781,1699,3,176
인하대병원,35486,5824,6333,5824,6333,0,392
인하대병원입구,35846,6673,12789,6639,12789,34,627
인하대역,37596,12,8161,12,8161,0,263
인하대역(1번출구),37066,76178,78398,76119,78398,59,4986
인하대역(7번출구),37091,106900,73912,106865,73912,35,5832
인하대역3번출구,37127,4194,21498,4191,21498,3,828
인하대역4번출구,37122,17095,6319,17081,6319,14,755
인하대정문,37099,22687,10541,22680,10541,7,1071
인하대정문,37104,11450,23903,11433,23903,17,1140
인하대후문,37165,62898,4510,62898,4510,0,2174
인하대후문,37166,1677,1514,1677,1514,0,102
인하대후문,37167,12620,70983,12617,70983,3,2696
인향아파트,40557,7689,525,7689,525,0,264
인향아파트,40559,442,6240,442,6240,0,215
인향아파트,41464,2697,127,2685,127,12,91
인향아파트,41465,43,5893,22,5893,21,191
인혜학교후문(원욱그린타운),41473,1475,920,1475,920,0,77
인혜학교후문(원욱그린타운),41518,767,3490,767,3490,0,137
인화1리마을회관,90210,12,2,12,2,0,0
인화1리마을회관,90211,14,16,14,16,0,0
인화리종점,43473,94,53,82,53,12,4
인화리종점,43945,0,0,0,0,0,0
인화성입구,90063,0,26,0,26,0,0
인화성입구,90064,11,3,9,3,2,0
인화여고,37547,4961,4450,4942,4450,19,303
인화여고,37548,8921,13250,8908,13250,13,715
일신동행정복지센터,40200,6010,3591,5996,3591,14,309
일신동행정복지센터,40205,87,2002,86,2002,1,67
일신동행정복지센터,40220,2554,2980,2554,2980,0,178
일신시장,40207,3770,4781,3769,4781,1,275
일신시장,40210,4207,2302,4184,2302,23,209
일신주공,40866,506,1038,506,1038,0,49
일신주공109동,40868,6435,4041,6435,4041,0,337
임광그대가.서창자이아파트,39514,3388,1743,3388,1743,0,165
임광그대가.서창자이아파트,39515,215,3904,215,3904,0,132
임광그대가103동,92025,3432,3159,3432,3159,0,212
임송촌,43423,11,11,11,11,0,0
임송촌,43802,78,99,78,99,0,5
임학사거리,41283,571,1964,571,1964,0,81
임학역,41290,14867,22195,14866,22195,1,1195
임학역,41292,23468,14107,23468,14107,0,1212
임학지하차도앞사거리,41287,18,3094,18,3094,0,100
임학지하차도앞사거리,41288,2294,18,2294,18,0,74
입구지,35300,56,3,56,3,0,1
입구지,35751,4,25,4,25,0,0
입구지입구,35477,16,66,16,66,0,2
입구지입구,35478,40,4,40,4,0,1
자동차매매단지,11020,296,735,296,735,0,33
자동차매매단지,11021,545,244,545,244,0,25
자동차매매단지,36094,251,5139,251,5139,0,173
자동차매매단지,37459,3810,354,3808,354,2,134
자연사박물관,43451,1,0,1,0,0,0
자연사박물관,43667,9,12,9,12,0,0
자이금호힐스테이트,42849,365,4687,362,4687,3,162
자이금호힐스테이트,42850,3449,434,3441,434,8,125
자이더테라스1단지,89297,1335,400,1335,400,0,55
자이더테라스1단지,89298,476,1361,476,1361,0,59
자이더테라스2단지,42864,1837,2573,1837,2573,0,142
자이더테라스2단지,42871,2888,1317,2888,1317,0,135
자이더테라스2단지(209동),89460,694,1093,694,1093,0,57
자이더테라스2단지(209동),89495,79,688,79,688,0,24
작은구월사거리,39239,5370,5631,5370,5631,0,354
작은구월사거리,39240,6407,6593,6395,6593,12,419
작전1동주민센터,41113,15634,8524,15622,8524,12,779
작전동삼성홈플러스,41044,16060,27697,16017,27697,43,1411
작전동삼성홈플러스,41050,19115,8986,19048,8986,67,906
작전동풍림아파트,41090,162,1070,162,1070,0,39
작전서운동행정복지센터,41103,554,2478,554,2478,0,97
작전서운동행정복지센터,41104,2550,452,2550,452,0,96
작전역,41561,8499,6691,8499,6691,0,490
작전역,41562,7532,8222,7532,8222,0,508
작전역 서해그랑블,41047,2719,2297,2717,2297,2,161
작전역 서해그랑블,41414,1087,3151,1087,3151,0,136
작전역1번출구,41095,12375,15504,12375,15504,0,899
작전역2번출구,41092,5105,6606,5105,6606,0,377
작전역3번출구,41076,9463,4631,9456,4631,7,454
작전역4번출구,41062,14404,30402,14357,30402,47,1445
작전역5번출구,41057,57580,33266,57516,33266,64,2930
작전역6번출구,41433,4225,26969,4225,26969,0,1006
작전역7번출구,41401,22885,6004,22885,6004,0,931
작전역8번출구,41093,10816,10739,10816,10739,0,695
작전중고.여고앞,41116,3249,3223,3226,3223,23,208
작전초등학교,41127,2922,2995,2898,2995,24,190
작전초등학교,41128,3195,2644,3174,2644,21,188
작전풍림아파트,41080,914,5872,914,5872,0,218
작전풍림아파트,41091,7673,2916,7673,2916,0,341
잔다리삼거리,35519,74,56,73,56,1,4
잔다리삼거리,35559,95,38,95,38,0,4
잔다리삼거리,35856,7,48,7,48,0,1
잔다리삼거리,35857,12,3,12,3,0,0
잔다리새마을,35866,37,91,37,91,0,4
잔다리새마을,35867,46,110,46,110,0,5
잔솔밭,43943,27,26,26,26,1,1
잔솔밭,43944,16,13,15,13,1,0
잠진도삼거리,35743,86,8,86,8,0,3
잠진도삼거리,35744,4,184,4,184,0,6
잠진도입구,35749,28,127,26,127,2,5
잠진도입구,35750,85,52,85,52,0,4
장경리공영주차장,44141,9,14,5,14,4,0
장경리공영주차장,44190,41,3,41,3,0,1
장경리해수욕장,44092,21,20,21,20,0,1
장경리해수욕장,44191,5,7,5,7,0,0
장곡.고촌고등학교,80066,281,170,281,170,0,14
장곡.고촌고등학교,80288,51,43,51,43,0,3
장곶돈대,43931,39,10,39,10,0,1
장곶돈대,43932,12,30,12,30,0,1
장곶횟집,43118,11,2,11,2,0,0
장곶횟집,43478,7,7,7,7,0,0
장구란,90349,0,3,0,3,0,0
장구란,90354,1,3,1,3,0,0
장기동,41345,699,52,699,52,0,24
장기동,41346,33,2530,33,2530,0,82
장기동,41347,3232,16329,3226,16329,6,631
장기동,41348,19572,3722,19571,3722,1,751
장도초등학교,39127,427,578,427,578,0,32
장도초등학교,39129,2110,832,2110,832,0,94
장릉입구,80046,27,164,27,164,0,6
장릉입구,80047,273,2,273,2,0,8
장미아파트,37044,6577,9433,6577,9433,0,516
장미아파트,37092,23200,10013,23134,10013,66,1071
장미아파트,37094,10992,17614,10978,17614,14,922
장미아파트(19동)앞,37474,3836,2875,3836,2875,0,216
장미아파트(19동)앞,37540,2737,5227,2733,5227,4,256
장서초등학교,39965,3762,719,3762,719,0,144
장서초등학교,39966,1133,5310,1133,5310,0,207
장수.서창동행정복지센터,39580,4712,8703,4712,8703,0,432
장수.서창동행정복지센터,39581,8688,2175,8688,2175,0,350
장수공영차고지,39566,628,46,503,46,125,21
장수공영차고지,92064,246,160,16,160,230,13
장수교,39336,565,648,565,648,0,39
장수교(서창동입구),39337,334,1123,334,1123,0,47
장수동,39373,581,1753,581,1753,0,75
장수동,39391,933,951,933,951,0,60
장수동,39393,3736,4848,3736,4848,0,276
장수빌라,39577,443,1049,443,1049,0,48
장수사거리,39389,12039,3346,12039,3346,0,496
장수사거리,39397,169,2263,169,2263,0,78
장수사거리,39501,2790,7514,2790,7514,0,332
장수사거리,39542,4823,310,4823,310,0,165
장수주공(청소년수련원),39417,39,2140,39,2140,0,70
장수주공(청소년수련원),39424,3274,44,3274,44,0,107
장수초등학교,39342,2801,1590,2801,1590,0,141
장수초등학교,39352,927,2197,927,2197,0,100
장수파출소,39543,31,745,31,745,0,25
장승마루,90028,0,19,0,19,0,0
장승마루,90029,17,0,17,0,0,0
장승마을,43200,2,46,2,46,0,1
장승마을,43714,102,0,91,0,11,3
장승백이시장,39280,3826,1515,3826,1515,0,172
장승백이시장,39282,551,3841,551,3841,0,141
장아초등학교,39873,1063,487,1063,487,0,50
장아초등학교,39874,141,1676,141,1676,0,58
장안,43418,21,33,21,33,0,1
장안,43445,70,27,67,27,3,3
장안마을,43133,14,0,14,0,0,0
장안마을,43855,1,5,1,5,0,0
장안말(구초지분교)입구,90083,71,121,71,121,0,6
장안말(구초지분교)입구,90084,109,172,109,172,0,9
장안말(온천스파),43144,26,14,26,14,0,1
장안말(온천스파),43253,32,0,32,0,0,1
장안말(온천스파),43892,11,14,11,14,0,0
장안사거리,37285,16077,3726,16074,3726,3,638
장안사거리,37295,4778,18489,4774,18489,4,750
장안촌동쪽,43933,1,26,1,26,0,0
장암마을,90155,105,55,104,55,1,5
장암마을,90156,27,37,27,37,0,2
장애인복지관,37249,2519,2740,2515,2740,4,169
장애인종합복지관,43320,3,0,3,0,0,0
장애인종합복지관,43627,2,11,2,11,0,0
장인가구,39706,258,202,258,202,0,14
장자말,43142,21,42,21,42,0,2
장자말,43257,64,0,61,0,3,2
장자촌,43141,38,0,38,0,0,1
장자촌,43255,0,1,0,1,0,0
장전,43415,37,2,35,2,2,1
장전,43500,1,10,1,10,0,0
장정2리마을회관,43665,2,97,2,97,0,3
장정2리마을회관,43693,148,0,146,0,2,4
장지포,90238,1,14,1,14,0,0
장지포,90239,27,4,27,4,0,1
장천사거리,37282,2058,2337,2058,2337,0,141
장천사거리,37610,182,1223,182,1223,0,45
장천사거리,37651,416,1358,416,1358,0,57
장촌길 입구,90379,12,4,12,4,0,0
장촌길 입구,90382,14,5,14,5,0,0
장촌마을,35475,208,13,208,13,0,7
장촌마을,35476,10,214,10,214,0,7
장촌빌라,35321,193,13,192,13,1,6
장촌빌라,35397,6,121,6,121,0,4
장하,43184,6,33,6,33,0,1
장하,43204,70,3,69,3,1,2
장화교회앞,43121,42,43,42,43,0,2
장화교회앞,43539,46,35,39,35,7,2
장화리학생수련원,43426,60,68,59,68,1,4
장화리학생수련원,43474,23,28,21,28,2,1
장흥낚시터,43211,1,1,1,1,0,0
장흥낚시터,43890,4,1,4,1,0,0
장흥리종점,43643,27,19,26,19,1,1
장흥리종점,43888,16,5,16,5,0,0
장흥매점,43641,2,1,2,1,0,0
장흥매점,43891,0,4,0,4,0,0
장흥삼거리,43153,90,7,90,7,0,3
장흥삼거리,43881,14,93,14,93,0,3
장흥저수지(성공회.해든뮤지움),90081,217,160,217,160,0,12
장흥저수지(성공회.해든뮤지움),90082,74,151,74,151,0,7
재능대·한국외대 송도캠퍼스,38754,109,0,109,0,0,3
재능대·한국외대 송도캠퍼스,38755,36,2869,36,2869,0,93
재능대학교서문,36058,20505,26702,20467,26702,38,1522
재능대학교서문,36119,12974,13511,12949,13511,25,854
재활용품수집장,43165,1,12,1,12,0,0
저수지관리소,43264,19,0,19,0,0,0
저수지휴게소,43567,19,40,19,40,0,1
저수지휴게소,43763,0,2,0,2,0,0
적두마을(월곳교회),43190,64,0,63,0,1,2
적두마을(월곳교회),43709,1,71,1,71,0,2
적석사입구,43348,12,71,12,71,0,2
적석사입구,43847,81,7,81,7,0,2
전동교회,35199,7512,4607,7512,4607,0,390
전동교회,35200,2668,8070,2668,8070,0,346
전득이고개입구,90187,7,29,7,29,0,1
전득이고개입구,90188,12,47,12,47,0,1
전들,43477,55,1,55,1,0,1
전들,43835,2,62,2,62,0,2
전등사남문,43515,148,330,147,330,1,15
전등사남문,43893,290,102,289,102,1,12
전등사동문,43521,156,726,155,726,1,28
전등사동문,43895,587,375,584,375,3,31
전소,35231,6982,5071,6972,5071,10,388
전소,35232,6198,6559,6197,6559,1,411
전원미술관앞,43387,260,11,258,11,2,8
전원미술관앞,43810,5,310,5,310,0,10
전인연립(종점),40132,105,364,105,364,0,15
절아래,90401,4,29,4,29,0,1
절아래,90402,33,5,33,5,0,1
점촌,43414,32,7,20,7,12,1
점촌,43806,2,42,2,42,0,1
젓개마을,35828,1,108,1,108,0,3
젓개마을,35829,5,5,5,5,0,0
젓개마을입구,35398,0,2,0,2,0,0
정광아파트(병무청),37008,4576,32,4576,32,0,148
정광아파트(병무청),37009,5,5116,5,5116,0,165
정광아파트.만수주공11단지,39476,7027,7273,7018,7273,9,461
정광아파트.만수주공11단지,39477,7350,4767,7338,4767,12,390
정기무역,35083,1526,216,1507,216,19,56
정다운그린빌,92024,2017,3347,2017,3347,0,173
정든마을아파트,40055,2403,4303,2403,4303,0,216
정든마을아파트,40057,4878,2071,4878,2071,0,224
정병원,40413,5276,4645,5276,4645,0,320
정부인천지방합동청사,37386,37235,16448,37220,16448,15,1731
정부인천지방합동청사,37388,27979,32823,27953,32823,26,1961
정비단지,37005,2180,1661,2180,1661,0,123
정비단지,37006,846,2115,846,2115,0,95
정서진삼거리,89234,1,463,1,463,0,14
정석항공과학고,37168,30203,6134,30193,6134,10,1172
정석항공과학고,37170,9522,30685,9517,30685,5,1297
정수사입구,43404,35,14,35,14,0,1
정수사입구,43436,18,30,18,30,0,1
정왕IC(미정차),92007,1,0,1,0,0,0
정하,43183,39,7,39,7,0,1
정하,43208,4,14,4,14,0,0
제물포시장,37310,795,611,795,611,0,45
제물포시장,37311,797,955,797,955,0,56
제물포여자중학교,37288,4122,2218,4122,2218,0,204
제물포여자중학교,37290,5952,5394,5947,5394,5,366
제물포여자중학교,37298,8172,10606,8172,10606,0,605
제물포역,37355,58779,36331,58754,36331,25,3068
제물포역,37364,33247,22731,33227,22731,20,1805
제물포역,37496,35797,43524,35781,43524,16,2558
제물포역,37498,21740,7467,21740,7467,0,942
제물포역,37502,31917,41469,31910,41469,7,2367
제물포역(동양빌딩),37339,1102,5536,1102,5536,0,214
제물포중학교,42064,2448,2781,2448,2781,0,168
제물포중학교,42065,2713,1835,2713,1835,0,146
제운사거리(청년창업특화거리),37175,3699,5678,3689,5678,10,302
제운사거리(청년창업특화거리),37534,5074,6351,5055,6351,19,368
제일시장,37316,7343,6346,7343,6346,0,441
제일시장,37329,10552,11556,10542,11556,10,713
제일시장사거리,37667,1153,754,1153,754,0,61
제일주유소,57020,2164,1205,2164,1205,0,108
제일주유소,57021,860,3462,860,3462,0,139
제일풍경채,42833,3577,3671,3577,3671,0,233
제일풍경채1차정문앞,89350,1708,1578,1708,1578,0,106
제일풍경채2차,89349,16,271,16,271,0,9
제일풍경채2차321동앞,42866,3101,1265,3101,1265,0,140
제일풍경채2차321동앞,42873,292,1235,292,1235,0,49
제일풍경채2차323동앞,42891,6595,6566,6595,6566,0,424
제일풍경채2차331동앞,42989,1914,3596,1914,3596,0,177
제적봉앞마을,90060,0,3,0,3,0,0
제적봉앞마을,90061,1,0,1,0,0,0
제적봉입구,43654,1,25,1,25,0,0
제적봉입구,43686,2,4,2,4,0,0
조광교회입구,43533,9,0,9,0,0,0
조광교회입구,43868,0,26,0,26,0,0
조달청(한양2차아파트),37511,6487,14738,6463,14738,24,684
조달청비축기지,35114,1402,5132,1389,5132,13,210
조달청비축기지,35115,3794,2002,3786,2002,8,186
조동초등학교,39464,2969,1730,2969,1730,0,151
조동초등학교,39465,26,1356,26,1356,0,44
조리미입구,80068,1481,43,1481,43,0,49
조리미입구,80069,40,1334,40,1334,0,44
조바위,90350,1,41,1,41,0,1
조바위,90351,20,3,20,3,0,0
조산,43192,8,84,7,84,1,2
조산,43334,115,12,113,12,2,4
조산교회,43172,2,44,2,44,0,1
조산교회,43338,91,2,89,2,2,3
조산초등학교,43189,47,273,46,273,1,10
조산초등학교,43593,194,9,194,9,0,6
종갱이,43180,52,154,52,154,0,6
종갱이,43288,103,41,103,41,0,4
종근당,40002,274,7,274,7,0,9
종근당,40005,16,799,16,799,0,26
종근당.충정로역,11002,207,7943,207,7943,0,262
종로약국,57005,734,1191,734,1191,0,62
종로약국,57007,2076,786,2076,786,0,92
종생마을,80161,983,146,979,146,4,36
종생마을,80162,149,1406,141,1406,8,50
종점(병무청),37014,2570,47,2570,47,0,84
종합터미널,37242,45099,21623,45058,21623,41,2152
종합터미널,39177,14243,39068,14236,39068,7,1719
종현동정보화마을,62043,35,122,35,122,0,5
종현동정보화마을,62044,127,31,127,31,0,5
좌동교차로,89371,2,96,2,96,0,3
좌동마을,42452,168,73,168,73,0,7
좌동마을,89253,102,211,102,211,0,10
좌동마을입구,42456,34,110,34,110,0,4
좌동마을입구,42928,149,33,149,33,0,5
주거단지,35118,427,373,427,373,0,25
주거단지,35120,234,799,233,799,1,33
주공12단지,35082,786,235,786,235,0,32
주공12단지,35084,481,395,481,395,0,28
주공6단지후문,40453,4616,2869,4616,2869,0,241
주공뜨란채아파트,40708,3413,2951,3413,2951,0,205
주공뜨란채아파트,40803,3767,3092,3767,3092,0,221
주공아파트,40867,429,869,429,869,0,41
주물단지,42291,1445,3752,1445,3752,0,167
주안1동행정복지센터,37385,5718,7120,5717,7120,1,414
주안2동치안센터,37302,7257,5129,7257,5129,0,399
주안4동행정복지센터,37333,164,217,164,217,0,12
주안4동행정복지센터,37335,48,411,48,411,0,14
주안5동행정복지센터,37526,755,990,755,990,0,56
주안7동행정복지센터,37214,20303,21108,20259,21108,44,1335
주안7동행정복지센터,37216,24353,18123,24303,18123,50,1370
주안국가산단역,37583,7020,809,7020,809,0,252
주안국가산단역,37584,17,2041,17,2041,0,66
주안남초등학교,37283,8058,8733,8058,8733,0,541
주안남초등학교,37284,11987,4708,11987,4708,0,538
주안도서관,37341,603,399,603,399,0,32
주안도서관,37342,466,465,464,465,2,30
주안매매단지,37586,323,210,323,210,0,17
주안북부역,37418,18821,12534,18821,12534,0,1011
주안북부역,37420,17305,13269,17305,13269,0,986
주안북초등학교,37417,4329,7741,4329,7741,0,389
주안사거리,37330,18452,12137,18436,12137,16,986
주안사거리,37514,3119,10408,3119,10408,0,436
주안시범공단,39927,224,490,224,490,0,23
주안아파트,37207,795,2384,793,2384,2,102
주안아파트,37209,1420,1277,1401,1277,19,87
주안역,37387,86313,32214,86241,32214,72,3823
주안역,37389,21143,78260,21141,78260,2,3206
주안역,37402,895,4023,895,4023,0,158
주안역,37506,25494,17541,25415,17541,79,1388
주안역센트레빌아파트,37430,8066,9755,8066,9755,0,574
주안역센트레빌아파트정문,37490,750,956,750,956,0,55
주안역환승정류장,37503,96595,72094,96595,72094,0,5441
주안역환승정류장,37617,148522,121689,148522,121689,0,8716
주안파크자이더플래티넘아파트,37201,20110,10415,20067,10415,43,984
주안파크자이더플래티넘아파트,37204,9935,20370,9876,20370,59,977
주안현대아파트,37358,17669,16710,17630,16710,39,1109
주원고개,39377,1176,3585,1162,3585,14,153
주원고개,39396,3438,9405,3435,9405,3,414
주적골,39510,442,1803,440,1803,2,72
주적골,39608,508,883,508,883,0,44
주택마을,90230,9,100,9,100,0,3
중고등학교,44106,26,69,12,69,14,3
중고등학교,44193,152,48,147,48,5,6
중고차매매단지엠파크허브,42038,375,681,375,681,0,34
중곡고개,43935,18,0,18,0,0,0
중구노인복지회관,35151,12709,10968,12698,10968,11,763
중구노인복지회관,35152,13096,12188,13078,12188,18,815
중구문화회관,35466,1,671,1,671,0,21
중구문화회관,35467,1666,381,1662,381,4,66
중구청,35157,2368,1184,2366,1184,2,114
중구청,35159,685,2912,683,2912,2,116
중구청소년수련관.하늘중학교,35824,2580,865,2580,865,0,111
중구청입구,35894,3,76,3,76,0,2
중독고개,43936,20,53,20,53,0,2
중박골입구,44123,3,13,3,13,0,0
중박골입구,44194,38,2,38,2,0,1
중봉로교차로,89420,1592,2328,1592,2328,0,126
중봉로교차로,89421,1340,742,1340,742,0,67
중부고용노동청(인천고용센터),39222,675,647,675,647,0,42
중부고용노동청(인천고용센터),39223,558,499,556,499,2,34
중산고등학교,35868,629,688,629,688,0,42
중산고등학교,35869,1341,1374,1341,1374,0,87
중산교차로,35652,861,611,861,611,0,47
중산교차로,35653,486,2958,486,2958,0,111
중산동,35305,1955,603,1955,603,0,82
중산동(까치빌라앞),35247,418,799,418,799,0,39
중산동(중촌),35272,673,1502,673,1502,0,70
중산동(중촌),35278,10,279,10,279,0,9
중산중고등학교,35817,285,307,285,307,0,19
중산중고등학교,35818,90,13,90,13,0,3
중산중학교,35656,1368,807,1368,807,0,70
중산중학교,35657,943,1781,943,1781,0,87
중앙공영아파트,41268,4200,1094,4199,1094,1,170
중앙공원사거리,39189,511,796,511,796,0,42
중앙방앗간,35852,10,22,10,22,0,1
중앙방앗간,35853,4,3,4,3,0,0
중앙사료,42014,2051,1400,2051,1400,0,111
중앙사료,42015,677,1027,677,1027,0,54
중앙산부인과,70176,7,280,7,280,0,9
중앙산부인과,70230,483,78,483,78,0,18
중앙시장,90125,2282,869,2218,869,64,101
중앙시장.고려궁지입구,43067,1283,1746,1271,1746,12,97
중앙아파트,40409,694,739,694,739,0,46
중앙아파트,42315,3354,2304,3354,2304,0,182
중앙하이츠,41110,3907,12248,3907,12248,0,521
중앙호수공원입구(호반베르디움),89245,11,655,11,655,0,21
중원고등학교,55078,2499,680,2499,680,0,102
중촌,43252,187,2,172,2,15,6
중촌,43369,3,59,3,59,0,2
중촌교차로,35436,125,550,125,550,0,21
중촌교차로,35443,1105,367,1105,367,0,47
중혈마을,43176,5,28,5,28,0,1
중혈마을,43299,73,1,70,1,3,2
중흥S클래스,42832,2767,1974,2767,1974,0,152
중흥S클래스,42847,728,543,728,543,0,41
중흥S클래스1차,42844,455,870,455,870,0,42
중흥S클래스1차,42845,837,638,837,638,0,47
중흥S클래스2차,42771,4993,1489,4989,1489,4,209
중흥S클래스2차,42856,4808,1073,4808,1073,0,189
중흥마을.은하마을,55070,616,307,616,307,0,29
지랏돌,90071,49,11,48,11,1,1
지랏돌,90072,1,22,1,22,0,0
지산리입구,43310,16,4,16,4,0,0
지산리입구,43751,1,7,1,7,0,0
지산입구(용진),43538,20,0,20,0,0,0
지산입구(용진),43679,3,18,3,18,0,0
지석리마을회관,90274,17,12,17,12,0,0
지석리망향단입구,90273,3,2,3,2,0,0
지석리오현부락,90275,36,28,36,28,0,2
지석초등학교입구,90277,35,10,35,10,0,1
지식정보단지역,38373,9171,1476,9171,1476,0,343
지식정보단지역,38403,10384,1333,10384,1333,0,377
지식정보단지역,38404,571,8793,571,8793,0,302
지식정보단지역(4번출구),38380,637,9964,637,9964,0,341
진고개(5연대입구),43380,214,140,207,140,7,11
진고개(5연대입구),43794,37,221,37,221,0,8
진광횟집앞,43507,33,8,32,8,1,1
진광횟집앞,43541,4,10,4,10,0,0
진달래아파트,37600,10,747,10,747,0,24
진도로르빌아파트,37471,2732,9320,2732,9320,0,388
진두방앗간,44129,0,26,0,26,0,0
진두방앗간,44195,11,3,11,3,0,0
진산과학고등학교,40640,8,344,8,344,0,11
진산과학고등학교,40915,118,6,118,6,0,4
진산중학교,40575,1167,2433,1167,2433,0,116
진산초등학교,40614,996,3528,996,3528,0,145
진산초등학교,40633,0,164,0,164,0,5
진산초등학교,40914,319,79,319,79,0,12
진솔인더스트리,89447,249,4,249,4,0,8
진솔인더스트리,89448,0,307,0,307,0,9
진주5단지503동앞,42089,3616,3110,3616,3110,0,216
진주상가,42544,3722,289,3699,289,23,129
진주아파트2단지,42092,416,11723,406,11723,10,391
진주아파트2단지6동,42084,129,7100,127,7100,2,233
진주아파트3단지,42086,9051,180,9016,180,35,297
진주아파트4단지,42077,3783,162,3769,162,14,127
진표에너지,42548,0,322,0,322,0,10
진흥아파트,37190,2804,2426,2795,2426,9,168
진흥아파트,37193,2474,3270,2463,3270,11,185
진흥아파트,37240,5858,4409,5849,4409,9,331
진흥아파트,37243,6301,10733,6297,10733,4,549
진흥아파트,39297,7624,7464,7624,7464,0,486
집단에너지,39064,83,122,83,122,0,6
집단에너지시설,39065,53,92,53,92,0,4
짓절미,43485,26,23,26,23,0,1
짓절미,43713,4,12,4,12,0,0
찬우물,39179,1305,3389,1303,3389,2,151
찬우물,39188,1957,852,1955,852,2,90
찬우물,43048,158,319,152,319,6,15
찬우물약수터,43851,132,301,130,301,2,13
참빛감리교회,42437,17253,10891,17243,10891,10,907
참좋은집,36160,416,23,411,23,5,14
참좋은집,36161,15,401,11,401,4,13
창골,43549,212,105,207,105,5,10
창리,43052,276,272,271,272,5,17
창리,43053,260,279,256,279,4,17
창리,43054,382,349,381,349,1,23
창리,43902,27,40,27,40,0,2
창리,43903,8,0,8,0,0,0
창신초등학교,42620,3630,3143,3627,3143,3,218
창신초등학교,42621,4271,4920,4267,4920,4,296
창후1리마을회관,43595,195,3,190,3,5,6
창후1리마을회관,43783,5,220,4,220,1,7
창후리입구,43604,159,8,158,8,1,5
창후리입구,43830,49,265,49,265,0,10
창후리종점,43774,30,76,26,76,4,3
창후정미소,43461,79,3,79,3,0,2
창후정미소,43600,11,46,11,46,0,1
채석장,38179,1102,356,1102,356,0,47
채플 갤러리,90422,2,0,2,0,0,0
채플 갤러리,90423,0,7,0,7,0,0
천곡,43409,143,4,137,4,6,4
천곡,43827,13,203,13,203,0,6
천촌,43411,14,181,13,181,1,6
천촌,43795,180,1,178,1,2,5
철곶,43653,7,12,7,12,0,0
철곶,43759,22,3,22,3,0,0
철산리검문소,43957,4,23,4,23,0,0
철산리검문소,43958,37,4,37,4,0,1
철산리입구,43685,57,18,56,18,1,2
철산리입구,43741,19,79,19,79,0,3
첨단초등학교,92014,513,4307,513,4307,0,155
청광플러스원101동앞,92070,437,3521,437,3521,0,127
청광플러스원102동앞,39946,839,106,839,106,0,30
청광플러스원아파트,39775,5861,3242,5861,3242,0,293
청광플러스원아파트,39786,2736,7718,2736,7718,0,337
청능로사거리,39622,41913,16583,41865,16583,48,1886
청능로사거리,39623,18251,39823,18196,39823,55,1873
청라1동행정복지센터,42744,13672,5519,13672,5519,0,619
청라1동행정복지센터,42745,7434,10617,7434,10617,0,582
청라1호문화공원,89470,1,0,1,0,0,0
청라1호문화공원,89471,3,0,3,0,0,0
청라2동행정복지센터,89039,3072,774,3072,774,0,124
청라2동행정복지센터,89042,1445,3435,1445,3435,0,157
청라3동행정복지센터,89374,1263,5943,1263,5943,0,232
청라3동행정복지센터,89375,7190,891,7190,891,0,260
청라BRT차고지입구,89336,19,544,19,544,0,18
청라BRT차고지입구,89337,622,43,622,43,0,21
청라BRT통합차고지,89508,12,71,12,71,0,2
청라BRT통합차고지,89522,99,2,98,2,1,3
청라고등학교,42784,2475,1318,2475,1318,0,122
청라고등학교,42785,1874,2433,1874,2433,0,138
청라골프아카데미,89255,99,62,99,62,0,5
청라골프아카데미,89256,59,137,59,137,0,6
청라국제도서관,42922,34,297,34,297,0,10
청라국제도서관,42923,379,96,379,96,0,15
청라국제도시역,89270,56629,658,56629,658,0,1847
청라국제도시역(경명대로),89034,8293,8982,8293,8982,0,557
청라국제도시역(서부산단방향),89043,25202,38880,25201,38880,1,2067
청라국제도시역(청라국제교방향),89215,36902,25383,36895,25383,7,2009
청라국제도시역푸르지오시티,89523,459,927,459,927,0,44
청라국제도시역푸르지오시티,89524,733,576,733,576,0,42
청라국제어린이집,89289,274,41,274,41,0,10
청라국제업무단지(골드클래스),42984,905,397,905,397,0,42
청라꽃농원,42991,70,89,70,89,0,5
청라달튼국제학교,42895,1255,507,1253,507,2,56
청라달튼국제학교,89121,915,972,913,972,2,60
청라도,42931,8,86,8,86,0,3
청라도,89127,7,80,7,80,0,2
청라디이스트,42961,90,1287,90,1287,0,44
청라디이스트(562동),42962,1922,3645,1920,3645,2,179
청라디이스트(567동),89017,1054,154,1052,154,2,38
청라로데오시티포레안,89419,115,383,115,383,0,16
청라로봇랜드,89246,21,13,21,13,0,1
청라로봇랜드,89247,0,60,0,60,0,1
청라모아미래도아파트604동,89344,2185,1469,2185,1469,0,117
청라모아미래도아파트정문,89353,28,80,28,80,0,3
청라문학공원,89480,101,39,101,39,0,4
청라백세요양병원,42944,167,95,167,95,0,8
청라백세요양병원,89179,172,149,172,149,0,10
청라복합문화센터,89218,221,1541,221,1541,0,56
청라복합문화센터,89219,1132,263,1132,263,0,45
청라센텀로제비앙,89295,1499,1390,1499,1390,0,93
청라센텀로제비앙,89296,1482,1428,1482,1428,0,93
청라센텀로제비앙정문앞,89346,49,19,49,19,0,2
청라센트럴에일린의뜰,42834,5033,4414,5032,4414,1,304
청라센트럴에일린의뜰104동,42990,3907,1782,3907,1782,0,183
청라센트럴에일린의뜰106동,42892,10662,5673,10654,5673,8,526
청라스타필드,89417,80,20,80,20,0,3
청라스타필드,89418,27,49,27,49,0,2
청라시티프라디움,89334,1837,2552,1837,2552,0,141
청라시티프라디움,89335,3171,1061,3170,1061,1,136
청라우미린,42862,639,5225,633,5225,6,189
청라우미린아파트,89290,3399,12324,3399,12324,0,507
청라웰카운티221동,89288,81,482,81,482,0,18
청라웰카운티223동,42997,1151,266,1151,266,0,45
청라자이,42742,10616,3272,10616,3272,0,448
청라중앙호수공원입구,89021,13734,10474,13734,10474,0,780
청라중앙호수공원입구,89024,8791,15098,8791,15098,0,770
청라중학교,42848,1014,1978,1014,1978,0,96
청라초등학교,89281,5947,7079,5947,7079,0,420
청라초등학교,89282,5085,7198,5085,7198,0,396
청라파크자이상가,89299,687,987,686,987,1,54
청라파크자이상가,89300,649,668,649,668,0,42
청라푸르지오,89217,789,1424,789,1424,0,71
청라푸르지오라피아노,89497,7,48,7,48,0,1
청라푸르지오라피아노,89498,10,32,10,32,0,1
청라한양수자인레이크블루,89348,2801,2209,2801,2209,0,161
청라한양수자인레이크블루,89351,2492,1479,2492,1479,0,128
청라한화꿈에그린,89123,1707,600,1707,600,0,74
청라한화꿈에그린,89124,586,1106,586,1106,0,54
청라호반베르디움.포리공원,42899,2046,350,2046,350,0,77
청라호반베르디움.포리공원,42919,681,1776,681,1776,0,79
청라호수공원(남측),42861,2540,783,2540,783,0,107
청라호수공원(남측),42863,978,2263,978,2263,0,104
청라호수공원한신더휴,42870,7469,1100,7456,1100,13,276
청라호수공원한신더휴아파트,89291,15815,6409,15815,6409,0,716
청라힐스테이트,42987,1052,2901,1052,2901,0,127
청라힐스테이트,42988,2802,662,2802,662,0,111
청람중학교,89018,1745,2091,1745,2091,0,123
청람중학교,89019,2489,2410,2489,2410,0,158
청람초등학교,89279,6640,10468,6640,10468,0,551
청람초등학교,89280,10351,8506,10351,8506,0,608
청량중학교,38086,10946,4824,10922,4824,24,508
청련사입구,43766,58,133,58,133,0,6
청련사입구,43841,80,1,80,1,0,2
청룡정,41633,137,28,133,28,4,5
청룡정,41634,3,161,3,161,0,5
청소년수련관,42612,2833,205,2832,205,1,98
청소년수련관,42613,44,2679,44,2679,0,87
청소년수련관,43078,70,18,63,18,7,2
청소년수련관,43079,10,46,10,46,0,1
청소년수련관.어린이과학관,41307,12329,9760,12322,9760,7,712
청소년수련관.어린이과학관,41308,7153,9354,7153,9354,0,532
청송1단지.중흥S클래스,80090,174,236,173,236,1,13
청송1단지.중흥S클래스,80102,553,140,553,140,0,22
청송2.3단지,80089,89,104,89,104,0,6
청송2.3단지,80101,331,65,331,65,0,12
청송마을.성우오스타,80329,178,125,178,125,0,9
청송부락,90092,0,5,0,5,0,0
청송부락,90093,5,1,5,1,0,0
청양골,42775,5,63,5,63,0,2
청운대삼거리(하늘꿈교회),37433,5192,4777,5169,4777,23,321
청운대삼거리(하늘꿈교회),37500,3215,3413,3204,3413,11,213
청운대후문.한전제물포지사,37632,469,941,469,941,0,45
청운대후문.한전제물포지사,37633,189,1274,189,1274,0,47
청정주말농장,39852,0,150,0,150,0,4
청천농장,40538,116,1604,116,1604,0,55
청천농장,42511,1386,316,1380,316,6,54
청천농장(종점),40520,3032,9,3032,9,0,98
청천농장입구,40558,350,192,350,192,0,17
청천농장입구,40809,0,387,0,387,0,12
청천도서관,40426,1089,1984,1089,1984,0,99
청천도서관,40427,918,875,918,875,0,57
청천동,40808,973,10,973,10,0,31
청천동무지개아파트,40617,792,3611,788,3611,4,142
청천동무지개아파트,40618,3248,821,3240,821,8,131
청천동차고지,40925,223,460,223,460,0,22
청천중학교,40449,1502,4727,1502,4727,0,200
청천중학교,40455,1535,5490,1535,5490,0,226
청천천공영주차장,40896,353,1565,351,1565,2,61
청천천공영주차장,41639,450,1428,443,1428,7,60
청천초등학교,40582,3518,6135,3503,6135,15,311
청천초등학교,40586,17747,6612,17732,6612,15,785
청천초등학교,40587,3589,9505,3589,9505,0,422
청천초등학교후문,40574,1803,13722,1803,13722,0,500
청천초등학교후문,40579,14051,1539,14051,1539,0,502
청천치안센터,40533,30717,14026,30686,14026,31,1443
청천치안센터,40537,10607,15019,10597,15019,10,826
청천푸르지오아파트,40488,11397,76,11397,76,0,370
청천푸르지오아파트,40515,11763,1599,11763,1599,0,431
청천푸르지오아파트,40516,1452,8502,1452,8502,0,321
청천푸르지오아파트,40811,7507,1678,7507,1678,0,296
청천푸르지오아파트,40812,842,4628,842,4628,0,176
청천푸르지오아파트,40894,23,2266,23,2266,0,73
청천하우스디아파트,40475,6014,1947,6014,1947,0,256
청천하우스디아파트,40477,729,4111,729,4111,0,156
청학동.한국전력남인천지사,38230,2941,4169,2941,4169,0,229
청학동.한국전력남인천지사,38239,8089,6212,8089,6212,0,461
청학사거리,38256,23733,15441,23733,15441,0,1263
청학사거리,38259,10364,15478,10364,15478,0,833
청학사거리,38509,1681,1893,1681,1893,0,115
청학아파트,38236,9671,6129,9671,6129,0,509
청학아파트,38341,7079,7683,7079,7683,0,476
청학중학교,38160,3658,4922,3658,4922,0,276
청학중학교,38161,3183,2032,3183,2032,0,168
청학중학교,38496,885,397,885,397,0,41
청학초등학교,38181,2765,3688,2765,3688,0,208
청학초등학교,38185,3035,2643,3035,2643,0,183
청학초등학교,38190,1852,2814,1852,2814,0,150
체육공원,90214,32,6,32,6,0,1
체육공원앞,35605,6,292,6,292,0,9
체육공원앞,35606,160,1,160,1,0,5
초은고등학교,89025,10128,7934,10128,7934,0,582
초은고등학교,89026,4156,11185,4156,11185,0,494
초정마을,41252,3682,3044,3682,3044,0,216
초정마을,41254,2146,833,2146,833,0,96
초지,43016,11,76,11,76,0,2
초지대교,43017,263,440,261,440,2,22
초지대교,43071,1429,462,1426,462,3,61
초지대교,43106,255,755,254,755,1,32
초지리,43026,114,196,112,196,2,10
초지리,43093,2,73,2,73,0,2
초지삼거리,43112,75,36,74,36,1,3
초지삼거리,43147,1,13,1,13,0,0
초지삼거리,43508,14,92,14,92,0,3
초지진,43024,25,96,25,96,0,3
초지진,43025,209,107,204,107,5,10
초지큰말,43260,23,0,20,0,3,0
초지큰말,43512,0,6,0,6,0,0
축현초등학교.인천시립박물관,38151,4819,3536,4819,3536,0,269
축현초등학교.인천시립박물관,38152,2939,4508,2939,4508,0,240
축협,43061,1192,936,1176,936,16,68
충렬사,43326,14,0,13,0,1,0
충렬사,43629,74,52,74,52,0,4
충성아파트,40117,762,1879,761,1879,1,85
충정로역2호선,22064,8790,94,8790,94,0,286
치마바위,43247,1,36,1,36,0,1
치마바위,43646,6,3,4,3,2,0
카페거리,35727,18,26,18,26,0,1
카페거리,35728,10,59,10,59,0,2
칼빈매니토바국제학교,38370,2569,5015,2569,5015,0,244
칼빈매니토바국제학교,38435,4256,901,4256,901,0,166
칼빈매니토바국제학교,38500,5283,3413,5277,3413,6,280
캐슬해모로,39845,1080,299,1080,299,0,44
캐슬해모로,39846,4950,539,4949,539,1,177
캐슬해모로,39848,478,931,478,931,0,45
캐슬해모로,39849,839,3910,838,3910,1,153
캠퍼스타운역,38419,10496,19961,10484,19961,12,982
캠퍼스타운역,38420,9707,7137,9707,7137,0,543
캠퍼스타운역(3번출구),38388,67,2670,67,2670,0,88
캠퍼스타운역(3번출구),38717,595,15,593,15,2,19
커넬워크,38415,1013,412,1013,412,0,45
커넬워크,38417,2927,1873,2925,1873,2,154
커넬워크,38753,131,2658,130,2658,1,89
커넬워크(4동),38527,735,1231,735,1231,0,63
컨벤시아,38372,1010,2547,1010,2547,0,114
코세스물류창고,89197,86,5,86,5,0,2
코스모스아파트,42098,369,1004,368,1004,1,44
코오롱더프라우,38439,27,1066,27,1066,0,35
코오롱아파트작전중.고.여고,41117,3109,3769,3090,3769,19,221
"쿠팡16,17센터",35865,464,642,464,642,0,35
쿠팡물류센터,89157,1,579,1,579,0,18
큐티엘,90218,28,12,27,12,1,1
큰말,43937,26,0,26,0,0,0
큰말,43938,1,21,1,21,0,0
큰말,43949,4,19,4,19,0,0
큰말,90309,2,13,2,13,0,0
큰무리선착장,35710,194,168,194,168,0,11
큰무리선착장,35712,49,418,49,418,0,15
큰방죽사거리,39144,2587,3266,2586,3266,1,188
큰방죽사거리,39145,1498,2880,1495,2880,3,141
큰방죽삼거리,39575,132,248,132,248,0,12
큰방죽삼거리,39576,54,432,54,432,0,15
큰산너머입구,44013,4,144,4,144,0,4
큰산너머입구,44014,183,4,183,4,0,6
킹스빌타운,41315,2757,3360,2757,3360,0,197
타운하우스공장.명진화학,89226,5,193,5,193,0,6
타운하우스공장.명진화학,89227,231,7,231,7,0,7
탄토 마을,90381,16,1,16,1,0,0
탄토마을,90378,0,11,0,11,0,0
탑재,43115,3,43,3,43,0,1
탑재,43327,286,227,286,227,0,16
탑재,43579,259,300,259,300,0,18
태경아파트,38275,8707,9429,8707,9429,0,585
태산.대진아파트,38294,2782,2726,2773,2726,9,177
태산아파트,41193,7716,11180,7709,11180,7,609
태산아파트,42227,666,475,666,475,0,36
태산아파트·하나아파트,41578,1199,2092,1199,2092,0,106
태신보세창고,89236,28,287,28,287,0,10
태신보세창고,89237,1122,34,1118,34,4,37
태양공단,42147,2088,1816,2088,1816,0,125
태양공단,42148,2862,2396,2862,2396,0,169
태양주택,40204,18,995,18,995,0,32
태영아파트,42298,3889,3327,3889,3327,0,232
태영아파트,42300,3567,3477,3567,3477,0,227
태평1차아파트,39241,3867,392,3867,392,0,137
태평1차아파트,39242,303,3789,303,3789,0,132
태평1차아파트,39516,9804,2145,9804,2145,0,385
태평1차아파트,39517,2296,10723,2296,10723,0,419
태평2차아파트,39225,12108,3574,12108,3574,0,505
태평2차아파트,39518,3703,8486,3703,8486,0,393
태평아파트,38083,8273,7765,8268,7765,5,517
태평아파트,41183,1511,176,1508,176,3,54
태평아파트.주안한신휴플러스아파트,37180,2909,4541,2881,4541,28,240
태평아파트.주안한신휴플러스아파트,37183,1486,2144,1473,2144,13,117
태평아파트1차(A),42326,4706,12367,4706,12367,0,550
태평아파트1차(B),42325,11611,4579,11611,4579,0,522
태평아파트2차(A),42317,2746,3392,2746,3392,0,198
태평아파트2차(B),42318,6444,3319,6443,3319,1,314
태평아파트입구,39274,128,1603,128,1603,0,55
태평아파트입구,39276,441,226,441,226,0,21
태평양산업,39066,2408,649,2408,649,0,98
태평양인천물류센터,42012,1384,1830,1384,1830,0,103
태화.두진아파트,39441,8338,5984,8317,5984,21,462
태화두진아파트,39445,6740,7141,6737,7141,3,447
태화아파트,37413,4621,3740,4621,3740,0,269
태화아파트,37416,5515,4695,5515,4695,0,329
태화아파트,40545,8232,4276,8227,4276,5,403
태화아파트,40810,1624,32,1624,32,0,53
태화한진아파트,41132,4616,2548,4616,2548,0,231
태화한진아파트612동,41135,1351,3118,1351,3118,0,144
택리,43233,21,12,21,12,0,1
택리,43859,2,33,2,33,0,1
택리교회,43229,16,71,16,71,0,2
택리교회,43860,80,5,80,5,0,2
테니스장,40456,259,191,259,191,0,14
테일코리아,89430,245,141,245,141,0,12
테일코리아,89431,504,398,504,398,0,29
테크노파크IT센타,39726,878,3088,878,3088,0,127
테크노파크IT센타,39727,3599,2201,3599,2201,0,187
테크노파크IT센터,39938,2803,4168,2803,4168,0,224
테크노파크역,38421,31642,19611,31637,19611,5,1653
테크노파크역,38422,30450,26182,30446,26182,4,1826
토지금고,37114,7936,2289,7912,2289,24,329
토지금고,37115,3749,10833,3726,10833,23,470
토지금고시장,37102,18317,13823,18305,13823,12,1036
토지금고시장앞,37509,10306,10860,10299,10860,7,682
통진성당,80137,1470,391,1470,391,0,60
통진성당,80138,327,1432,327,1432,0,56
통진중고등학교,35073,3158,671,3158,671,0,123
통진중고등학교,35074,586,2955,586,2955,0,114
트러스(서구장애인직업재활시설),42809,352,8,352,8,0,11
트러스(서구장애인직업재활시설),42810,0,232,0,232,0,7
트레지움1단지.다니엘병원,55076,2225,813,2225,813,0,98
트레지움1단지.다니엘병원,55077,754,1691,754,1691,0,78
트루엘에코시티아파트(후문),42049,2013,1391,2013,1391,0,109
트루엘에코시티아파트(후문),42050,1918,1607,1918,1607,0,113
파라곤보타닉파크,89422,2903,34,2903,34,0,94
파라곤보타닉파크(고산터널),89395,9264,2849,9264,2849,0,390
파라다이스공원,43391,112,31,112,31,0,4
파라다이스공원,43828,2,161,1,161,1,5
파라다이스시티역,35748,0,4,0,4,0,0
팔도주유소,40175,268,402,268,402,0,21
팔도주유소,40774,10820,7284,10820,7284,0,584
팬더아파트,39968,437,5,437,5,0,14
팬더아파트,39980,0,277,0,277,0,8
펜션마을,90392,0,13,0,13,0,0
펜션마을,90393,6,0,6,0,0,0
평전,43258,1,82,1,82,0,2
평화전망대,43743,42,87,41,87,1,4
평화전망대,43760,43,4,43,4,0,1
포내교회,35874,11,2,11,2,0,0
포내교회,35875,6,16,6,16,0,0
포도마을,55039,2993,3016,2993,3016,0,193
포도마을사거리.현대백화점.이마트,55055,9746,8780,9745,8780,1,597
포도밭,43939,16,8,16,8,0,0
포도밭,43940,11,24,11,24,0,1
포레시안101동앞,39729,6221,5312,6221,5312,0,372
포레시안101동앞,39730,4945,3955,4945,3955,0,287
포스코타워앤쉐라톤호텔,38491,2953,1795,2953,1795,0,153
푸르지오더베뉴(3216동),89442,571,1810,571,1810,0,76
푸르지오더베뉴후문,89423,19,2434,19,2434,0,79
푸르지오더스카이,35844,4339,2220,4339,2220,0,211
푸르지오더스카이,35845,2348,2682,2346,2682,2,162
푸르지오더스카이256동,35508,412,42,412,42,0,14
푸르지오더스카이256동,35509,47,302,47,302,0,11
푸르지오월드마크,38471,9200,14150,9179,14150,21,753
푸르지오하버뷰,38456,235,655,235,655,0,28
푸르지오하버뷰,38522,1075,2658,1075,2658,0,120
푸른초장,90052,1,189,1,189,0,6
푸른초장,90053,101,0,98,0,3,3
풍류산,90129,1,27,1,27,0,0
풍류산,90130,29,0,27,0,2,0
풍림1단지정문,70007,5,914,5,914,0,29
풍림1차205동,35255,3241,5723,3241,5723,0,289
풍림1차205동,35256,8634,4432,8631,4432,3,421
풍림1차아파트,42970,4534,12050,4533,12050,1,534
풍림1차아파트,,13082,4345,13082,4345,0,562
풍림2.3차아파트,38350,9236,2488,9236,2488,0,378
풍림2단지,70010,7,1228,7,1228,0,39
풍림2차아파트,38049,5348,14054,5345,14054,3,625
풍림2차아파트,38050,7287,5673,7261,5673,26,418
풍림3단지정문,70003,210,195,210,195,0,13
풍림3차아파트,42366,8412,5112,8412,5112,0,436
풍림6단지,35124,2337,600,2337,600,0,94
풍림아이원,36114,122,1128,122,1128,0,40
풍림아이원,36115,6776,2029,6773,2029,3,284
풍림아이원,36121,2641,9483,2640,9483,1,391
풍림아이원,41441,4227,2103,4226,2103,1,204
풍림아이원1차·금호어울림아파트,42642,5305,8,5305,8,0,171
풍림아이원1차·금호어울림아파트,42646,15,5012,15,5012,0,162
풍림아이원2차아파트,42485,10043,55,10043,55,0,325
풍림아이원4차아파트,42645,11,4630,11,4630,0,149
풍림아이원아파트,37034,19553,9066,19553,9066,0,923
풍림아파트,36122,7011,568,7000,568,11,244
풍림아파트,37245,24917,6885,24912,6885,5,1025
풍림아파트,37246,5869,13512,5869,13512,0,625
풍림아파트,38255,3561,6507,3561,6507,0,324
풍림아파트,39162,8434,11802,8427,11802,7,652
풍림아파트,39163,12843,6595,12829,6595,14,627
풍림아파트,41374,2691,2552,2691,2552,0,169
풍림아파트,70008,609,6,605,6,4,19
풍림아파트(소래마을),39120,1069,3345,1064,3345,5,142
풍림아파트104동,40898,7927,6579,7927,6579,0,467
풍림아파트104동,40899,5245,6064,5245,6064,0,364
풍림아파트상가,70043,235,397,235,397,0,20
풍림아파트상가,70044,425,143,425,143,0,18
풍림엑슬루타워,42830,7684,8721,7683,8721,1,529
풍무역,80167,371,4704,371,4704,0,163
풍무역,80168,3509,378,3509,378,0,125
풍물시장,35054,292,1287,283,1287,9,50
풍물시장,35055,205,8,204,8,1,6
풍물시장,43941,102,9124,102,9124,0,297
풍산빌라 입구,90384,3,5,3,5,0,0
풍산특수금속,90219,17,8,16,8,1,0
프라임,39643,5159,1438,5159,1438,0,212
프리상뜨아파트,40230,108,3957,108,3957,0,131
프린피아통합물류센터,89235,325,5,325,5,0,10
하나개삼거리,35733,18,52,18,52,0,2
하나개삼거리,35734,16,51,16,51,0,2
하나개해수욕장,35737,451,2131,448,2131,3,83
하나글로벌캠퍼스,89444,1529,657,1529,657,0,70
하나글로벌캠퍼스,89445,540,4334,540,4334,0,157
하나금융그룹통합데이터센터,89265,336,1915,336,1915,0,72
하나금융그룹통합데이터센터,89294,283,239,283,239,0,16
하나로쇼핑,37118,3799,8411,3757,8411,42,393
하나모터스,89451,320,11,320,11,0,10
하나모터스,89452,2,224,2,224,0,7
하나아파트,37052,9464,3266,9464,3266,0,410
하나아파트,40546,1119,1684,1119,1684,0,90
하나아파트,41250,4751,6211,4737,6211,14,353
하나아파트,41574,3332,699,3332,699,0,130
하늘도시중심상가,35821,2084,422,2084,422,0,80
하늘도시중심상가,35822,444,2071,444,2071,0,81
하늘문화센터,35826,12,86,12,86,0,3
하늘문화센터,35827,43,1,43,1,0,1
하늘문화센터입구,35766,8,58,8,58,0,2
하늘문화센터입구,35767,25,1,25,1,0,0
하늘중학교,35823,819,1396,819,1396,0,71
하늘초등학교후문,35499,1535,472,1534,472,1,64
하늘초등학교후문,35500,433,1709,433,1709,0,69
하늘휴게소,70220,2011,7778,2011,7778,0,315
하늘휴게소,70221,6970,2167,6970,2167,0,294
하룩,43157,30,181,30,181,0,6
하룩,43281,205,39,197,39,8,7
하리마을회관,90243,1,14,1,14,0,0
하리마을회관,90244,10,1,9,1,1,0
하리선착장,90240,2,23,2,23,0,0
하야동,41438,296,402,295,402,1,22
하야동,41439,433,566,431,566,2,32
하얀마을,55035,2320,2571,2320,2571,0,157
하얀집민박,43440,33,1,30,1,3,1
하얀집민박,43497,7,17,6,17,1,0
하얏트호텔,35028,1163,8803,1162,8803,1,321
하얏트호텔,35206,2988,3467,2988,3467,0,208
하우고개,43275,62,112,58,112,4,5
하우고개,43577,123,63,118,63,5,6
하우스앞,43174,15,0,15,0,0,0
하우스앞,43231,1,28,1,28,0,0
하우스토리,41569,210,227,210,227,0,14
하우스토리,41570,100,1410,99,1410,1,48
하우스토리,41606,387,467,387,467,0,27
하우스토리,41626,632,401,632,401,0,33
하우스토리만수아파트,39301,1124,944,1121,944,3,66
하일부락입구,43967,3,0,3,0,0,0
하일부락입구,43971,0,6,0,6,0,0
하점공단,43448,13,54,13,54,0,2
하점공단,43755,40,5,35,5,5,1
하점면사무소,43738,319,164,308,164,11,15
하점면사무소,43834,148,333,141,333,7,15
하점순복음교회,90222,168,1,166,1,2,5
하점순복음교회,90223,0,59,0,59,0,1
하점우체국,43817,532,75,515,75,17,19
하점우체국,43838,96,685,95,685,1,25
하점초등학교,43739,1,143,1,143,0,4
하점초등학교,43836,177,12,174,12,3,6
하정초등학교,40044,1647,980,1647,980,0,84
하정초등학교,,739,2076,739,2076,0,90
학마을한진아파트정문,41293,2036,2921,2036,2921,0,159
학산사거리,37025,6755,228,6755,228,0,225
학산사거리,37027,228,3448,228,3448,0,118
학산사거리,37562,2112,1446,2112,1446,0,114
학산소극장,37169,20092,3594,20087,3594,5,764
학산소극장,37173,7985,18161,7982,18161,3,843
학생안전체험관,39284,2535,4549,2530,4549,5,228
학익.원흥아파트,37015,1922,46,1922,46,0,63
학익2동행정복지센터,37150,14309,7592,14276,7592,33,706
학익2동행정복지센터,37151,8215,13779,8199,13779,16,709
학익고등학교,37029,11601,3078,11601,3078,0,473
학익고등학교,37505,3628,11553,3628,11553,0,489
학익동구치소,37139,376,927,376,927,0,42
학익동성당앞,37630,1579,21,1579,21,0,51
학익동성당앞,37631,81,748,81,748,0,26
학익사거리,37058,7,665,7,665,0,21
학익사거리,37075,3060,1380,3060,1380,0,143
학익사거리,37077,2087,6426,2087,6426,0,274
학익사거리(동아풍림아파트),37084,11128,5039,11116,5039,12,521
학익사거리(동아풍림아파트),37089,9911,10857,9871,10857,40,669
학익시장,37106,14370,5485,14346,5485,24,640
학익시장,37112,3413,12006,3406,12006,7,497
학익시장(법원검찰청),37080,9493,4274,9463,4274,30,444
학익시장앞,37082,4105,5476,4101,5476,4,309
학익여자고등학교,37140,557,1074,557,1074,0,52
학익여자고등학교,37566,762,1231,762,1231,0,64
학익풍림아파트,37487,25,2874,25,2874,0,93
한가라지고개,90157,9,4,9,4,0,0
한가라지고개,90158,4,19,4,19,0,0
한가라지입구,90159,9,6,8,6,1,0
한가라지입구,90160,0,9,0,9,0,0
한가람마을우미린.호수이편한세상,80318,1006,3533,1006,3533,0,146
한강센트럴블루힐.모아엘가2차,80375,251,331,251,331,0,18
한국가스공사,39061,706,962,706,962,0,53
한국가스공사,89273,219,674,219,674,0,28
한국가스공사,89274,102,522,102,522,0,20
한국가스공사인천지역본부,89114,10,64,10,64,0,2
한국가스공사인천지역본부,89115,58,37,58,37,0,3
한국건설생활환경시험연구원,39312,392,282,392,282,0,21
한국건설생활환경시험연구원,39315,736,3497,736,3497,0,136
한국공항공사,25002,67,1161,67,1161,0,39
한국공항공사,25144,28,13,28,13,0,1
한국국토정보공사인천북부지사,42278,5615,6433,5605,6433,10,388
한국국토정보공사인천북부지사,42280,6277,3818,6253,3818,24,325
한국글로벌셰프고등학교,43246,163,74,162,74,1,7
한국글로벌셰프고등학교,43381,36,59,35,59,1,3
한국단자공업연구소,38763,174,378,174,378,0,17
한국단자공업연구소,38764,31,155,31,155,0,6
한국도심공항터미널,35400,5,83,5,83,0,2
한국도심공항터미널,35408,17,188,17,188,0,6
한국도심공항터미널,35417,77,7,77,7,0,2
한국도심공항터미널앞,35645,31,5,31,5,0,1
한국마쓰이,39055,848,1208,848,1208,0,66
한국마쓰이,39057,2704,1446,2704,1446,0,133
한국만화박물관,40583,5326,14501,5326,14501,0,639
한국무역센터.삼성역,23201,1467,18,1467,18,0,47
한국무역센터.삼성역,23251,3271,3372,3271,3372,0,214
한국산업단지공단,39060,735,99,735,99,0,26
한국산업단지공단,39067,46,744,46,744,0,25
한국생산기술연구원,38448,455,497,455,497,0,30
한국생산기술연구원(주조기술센터),42271,395,718,395,718,0,35
한국생산기술연구원(주조기술센터),42719,372,242,372,242,0,19
한국샤프(로얄금속),40600,2548,3687,2543,3687,5,201
한국선교역사기념관,40673,1897,753,1897,753,0,85
한국아파트,37017,3273,9560,3272,9560,1,413
한국아파트,37682,33,239,33,239,0,8
한국아파트,38154,3068,1823,3068,1823,0,157
한국아파트,40714,92,1762,92,1762,0,59
한국아파트,40715,1970,91,1970,91,0,66
한국아파트,40790,14978,15667,14972,15667,6,988
한국아파트,40791,14981,12285,14956,12285,25,879
한국아파트,40792,4125,14906,4104,14906,21,613
한국아파트,40816,10356,9242,10356,9242,0,632
한국아파트,41206,6380,3789,6349,3789,31,328
한국아파트,41208,2200,4022,2180,4022,20,200
한국아파트,80057,2172,42,2172,42,0,71
한국외대송도캠퍼스,38768,0,96,0,96,0,3
한국은행,35898,1027,1854,1026,1854,1,92
한국전력,42947,41,237,41,237,0,8
한국지엠청라주행시험장,89412,1512,1255,1512,1255,0,89
한국지엠청라주행시험장,89413,1077,730,1077,730,0,58
한국지엠출고문,40560,3884,6560,3879,6560,5,336
한국지엠출고문,40570,5258,3617,5258,3617,0,286
한국콘베어공업,92049,2,0,2,0,0,0
한국타이어인천물류센터,89221,617,1275,612,1275,5,61
한국타이어인천물류센터,89222,671,1009,670,1009,1,54
한국특수주물(주),42575,352,191,352,191,0,17
한국폴리텍2대학남인천캠퍼스,37448,1012,913,1012,913,0,62
한국폴리텍2대학남인천캠퍼스,37450,773,620,773,620,0,44
한남시티플라자,40253,19821,12756,19812,12756,9,1050
한들마을입구(유아교육진흥원),42370,8942,6046,8938,6046,4,483
한들마을입구(유아교육진흥원),42371,4081,4299,4080,4299,1,270
한라비발디,35459,9257,3427,9254,3427,3,409
한라비발디,35460,9090,14707,9088,14707,2,767
한라비발디,89180,2451,1409,2451,1409,0,124
한라비발디,89181,1584,3247,1584,3247,0,155
한라비발디정문,89373,54,1388,54,1388,0,46
한라비발디후문.화성파크드림,35658,621,1040,621,1040,0,53
한라시멘트,35291,144,484,144,484,0,20
한라아파트,39117,1349,3558,1348,3558,1,158
한라아파트,39118,5314,1568,5276,1568,38,222
한림병원,41130,15038,11102,15038,11102,0,843
한림병원,41131,12003,18167,12003,18167,0,973
한미반도체,42754,581,1274,581,1274,0,59
한미반도체,42755,305,238,305,238,0,17
한빛초교앞,39773,1712,7488,1712,7488,0,296
한빛초교앞,39774,6375,2790,6375,2790,0,295
한사랑어린이집,42461,13,94,13,94,0,3
한성아파트,89020,1949,1908,1949,1908,0,124
한성자동차학원,42091,785,1607,785,1607,0,77
한수조경,43681,5,11,5,11,0,0
한수조경,43882,3,3,3,3,0,0
한스엔지니어링,42276,439,201,439,201,0,20
한스엔지니어링,42279,483,476,483,476,0,30
한신더휴스카이파크,35654,1163,1324,1163,1324,0,80
한신더휴스카이파크,35655,1819,962,1819,962,0,89
한신더휴어반파크,89521,563,1114,563,1114,0,54
한신더휴테라스,35761,135,35,135,35,0,5
한신더휴테라스,35762,56,82,56,82,0,4
한신빌리지(A),42249,623,2545,623,2545,0,102
한신빌리지(B),42246,3793,620,3778,620,15,142
한신빌리지(C),42229,2604,566,2581,566,23,102
한신빌리지아파트,42230,496,1394,493,1394,3,60
한신삼부아파트,40806,2198,2695,2198,2695,0,157
한신아파트,37262,4999,3808,4991,3808,8,284
한신아파트,37264,8148,9655,8135,9655,13,574
한신아파트,37267,13269,9743,13258,9743,11,742
한신아파트,41066,2253,1722,2246,1722,7,128
한신아파트,41067,2214,1860,2202,1860,12,131
한신아파트,42095,31,930,24,930,7,31
한신휴아파트,40245,4885,59,4885,59,0,159
한신휴아파트,42105,41763,19277,41658,19277,105,1969
한신휴아파트,42106,3334,2025,3334,2025,0,172
한양2차아파트,37512,12318,4229,12318,4229,0,533
한양2차아파트,38055,6101,4811,6093,4811,8,352
한양공구,39664,85,0,85,0,0,2
한양공구,39753,0,31,0,31,0,1
한양공구,42071,353,7678,353,7678,0,259
한양쇼핑,40331,1423,7973,1423,7973,0,303
한양쇼핑,40333,4546,2187,4538,2187,8,217
한양수자인,35450,3588,363,3588,363,0,127
한양수자인,42868,5005,2354,5003,2354,2,237
한양수자인,42893,2901,3994,2898,3994,3,222
한양수자인(후문),35537,4404,859,4404,859,0,169
한양아파트,37076,2019,6624,2010,6624,9,278
한양아파트,37079,5973,703,5973,703,0,215
한양아파트,40269,452,304,452,304,0,24
한양아파트,40310,15941,4369,15941,4369,0,655
한양아파트,40356,14242,9843,14235,9843,7,776
한양아파트,40905,43,396,43,396,0,14
한양아파트2차,38062,3592,6189,3592,6189,0,315
한양화학,42523,3608,1550,3608,1550,0,166
한일금속,89487,6,1382,6,1382,0,44
한일금속,89488,1137,15,1133,15,4,37
한일베라체,42839,4979,1353,4974,1353,5,204
한일베라체,42865,1504,2812,1496,2812,8,139
한일베라체,42948,3819,1672,3819,1672,0,177
한일아파트,41295,1116,2262,1112,2262,4,108
한일아파트,41296,2139,1167,2132,1167,7,106
한일아파트,80195,74,1274,74,1274,0,43
한일튜브(주),42576,416,243,416,243,0,21
한전사택,44090,20,39,20,39,0,1
한전사택,44197,2,0,2,0,0,0
한전온수출장소,43012,245,478,240,478,5,23
한주글로벌,89306,54,420,54,420,0,15
한진,38540,14,253,14,253,0,8
한진,38541,273,11,273,11,0,9
한진아파트,38016,25440,17352,25432,17352,8,1380
한진아파트,41355,236,468,236,468,0,22
한진아파트후문,41300,2314,502,2314,502,0,90
한풍산업,39014,534,826,534,826,0,43
한화2차,40363,3799,1290,3799,1290,0,164
한화꿈에그린,42860,1220,390,1220,390,0,51
한화꿈에그린,42872,434,1185,434,1185,0,52
한화꿈에그린정문,89372,2940,2515,2940,2515,0,175
한화아파트,40351,12274,7226,12265,7226,9,629
한화아파트,40379,2541,2475,2541,2475,0,161
한화아파트,40380,4561,2411,4561,2411,0,224
한화아파트,41375,3745,3025,3744,3025,1,218
한화지구공원앞,39654,1695,969,1695,969,0,85
한희빌딩,39311,1950,4911,1940,4911,10,221
함박도서관,38286,5273,3094,5273,3094,0,269
함박도서관,38742,425,2036,425,2036,0,79
함박마을,38277,6772,2772,6772,2772,0,307
함박마을문화복지센터,38291,4731,1795,4731,1795,0,210
함박마을문화복지센터,38741,213,2243,213,2243,0,79
함박마을입구,38285,2945,9073,2945,9073,0,387
함허동천,43352,7,63,7,63,0,2
함허동천,43403,75,11,74,11,1,2
합동청사역,35207,20309,5326,20309,5326,0,826
합정역,14220,256,10388,256,10388,0,343
합정역,23029,239,27337,239,27337,0,889
합정역,23030,34682,611,34680,611,2,1138
항동7가버스차고지,35609,1330,30,1147,30,183,43
항동7가버스차고지,35610,220,940,88,940,132,37
항동7가버스차고지(삼거리),35704,112,336,10,336,102,14
항동7가버스차고지(삼거리),35705,678,16,618,16,60,22
항운아파트,35065,15483,3869,15400,3869,83,624
항운아파트,35481,1103,8123,1096,8123,7,297
항운아파트,35602,295,2113,295,2113,0,77
항진축산,39056,834,1749,834,1749,0,83
항진축산,39058,1763,1203,1763,1203,0,95
항청리종점,43558,141,97,134,97,7,7
항포,90247,0,2,0,2,0,0
항포,90248,13,0,13,0,0,0
해광병원,40292,72,2469,72,2469,0,81
해넘이마을,90135,9,25,9,25,0,1
해넘이마을,90136,56,29,56,29,0,2
해돋이공원,38008,45,275,45,275,0,10
해돋이공원,38010,430,724,430,724,0,37
해돋이공원,38718,48,92,48,92,0,4
해돋이도서관,38729,247,28,247,28,0,8
해돋이도서관,38730,7,570,7,570,0,18
해뜨는집앞,35531,6,18,6,18,0,0
해뜨는집앞,35726,35,3,35,3,0,1
해망,90352,0,4,0,4,0,0
해망,90353,10,0,10,0,0,0
해맞이공원앞,35616,482,960,482,960,0,46
해맞이공원앞,35617,767,331,767,331,0,35
해명초등학교앞,90179,14,17,11,17,3,1
해명초등학교앞,90180,18,156,18,156,0,5
해모로월드뷰,39794,1774,414,1774,414,0,70
해모로월드뷰,39805,461,1380,461,1380,0,59
해물탕거리,40782,3760,2177,3760,2177,0,191
해병2사단.향동,80054,773,679,773,679,0,46
해사고등학교,35503,1326,14,1326,14,0,43
해사고등학교.한국이민사박물관,35126,20,1980,20,1980,0,64
해서초등학교,41166,477,672,477,672,0,37
해서초등학교,41168,550,1180,550,1180,0,55
해성단조,42813,54,0,54,0,0,1
해송노인요양병원,35552,0,92,0,92,0,2
해송노인요양병원,35553,9,3,9,3,0,0
해수워터피아,42082,3331,704,3331,704,0,130
해수워터피아,42083,1140,6325,1140,6325,0,240
해안도로신항만교,39001,231,774,231,774,0,32
해안도로신항만교,39002,613,612,613,612,0,39
해암약수,90161,16,2,16,2,0,0
해암약수,90162,7,21,7,21,0,0
해양경찰청,38014,2010,3412,2006,3412,4,174
해양경찰청,38015,6083,3739,6078,3739,5,316
해양경찰청,38411,10094,7663,10094,7663,0,572
해양기계,39532,14,32,14,32,0,1
해양기계,39696,2,125,2,125,0,4
해오름민박,43413,63,25,62,25,1,2
해오름민박,43442,19,73,19,73,0,2
해원고등학교,42964,18,597,18,597,0,19
해원중학교,42972,1735,107,1735,107,0,59
해원중학교,42973,102,938,102,938,0,33
해원중학교후문,42965,1446,564,1444,564,2,64
해피타운앞,44139,15,4,15,4,0,0
해피타운앞,44198,24,91,23,91,1,3
핸즈코퍼레이션,89262,7,2319,7,2319,0,75
핸즈코퍼레이션,89263,2,25,2,25,0,0
햇내로공원입구,35777,8,1,8,1,0,0
햇내로공원입구,35784,0,33,0,33,0,1
행복마을입구,35687,64,12,62,12,2,2
행복마을입구,35690,18,74,17,74,1,2
행자골,43350,0,10,0,10,0,0
행자골,43583,15,4,15,4,0,0
행정복지센터사거리,40332,1378,2893,1378,2893,0,137
향나무골,43131,16,17,16,17,0,1
향나무골,43648,50,16,49,16,1,2
향동해병2사단,80055,851,1394,850,1394,1,72
향촌휴먼시아2단지,39741,8960,15361,8960,15361,0,784
허브주유소,35446,301,406,301,406,0,22
허브주유소,35447,411,7707,410,7707,1,261
허튼개,90119,12,4,12,4,0,0
허튼개,90120,7,8,7,8,0,0
헤나무,43199,2,33,2,33,0,1
헤나무,43317,34,10,34,10,0,1
혁이네슈퍼,40738,15,724,15,724,0,23
혁이네슈퍼,40739,329,40,329,40,0,11
현광아파트,37007,2260,6,2260,6,0,73
현광아파트,37488,3,2570,3,2570,0,83
현광아파트,39380,17645,17675,17616,17675,29,1139
현광아파트,41071,5824,1747,5824,1747,0,244
현광아파트,41432,2896,6380,2896,6380,0,299
현광아파트,42258,133,260,133,260,0,12
현광아파트,42260,609,238,607,238,2,27
현광아파트(호산부인과),39376,31982,16313,31934,16313,48,1557
현광아파트후문,37560,2584,16,2584,16,0,83
현광아파트후문앞,37559,14,1454,14,1454,0,47
현대.태화아파트,41402,615,3706,615,3706,0,139
현대102동,40146,2221,805,2221,805,0,97
현대121동,40137,5676,792,5676,792,0,208
현대1단지관리사무소,40740,209,2318,209,2318,0,81
현대1차아파트,38061,6655,3779,6655,3779,0,336
현대1차아파트,41365,9832,833,9832,833,0,344
현대1차아파트정문,41367,102,364,102,364,0,15
현대207동,40168,515,8924,515,8924,0,304
현대209동,40167,9355,541,9355,541,0,319
현대2차아파트,38173,1900,2597,1894,2597,6,145
현대2차아파트,41106,728,4351,728,4351,0,163
현대2차아파트,41112,8603,701,8603,701,0,300
현대2차아파트,41366,665,6088,665,6088,0,217
현대2차아파트정문,41364,448,5830,448,5830,0,202
현대310동(서중학교),40097,658,2137,658,2137,0,90
현대3단지,40127,9648,6639,9646,6639,2,525
현대3단지,40129,8946,11341,8946,11341,0,654
현대3차아파트,38168,19013,11457,18965,11457,48,982
현대3차아파트,38342,18851,16598,18826,16598,25,1143
현대4차아파트,38158,2049,2444,2049,2444,0,144
현대4차아파트,38183,2604,2987,2590,2987,14,180
현대4차아파트,38186,3661,1478,3651,1478,10,165
현대5차,40405,10832,6568,10830,6568,2,561
현대5차,40408,6491,4102,6485,4102,6,341
현대5차아파트,38176,3793,1567,3778,1567,15,172
현대동부시장,36041,12283,5743,12218,5743,65,581
현대모닝.임광그대가아파트,39579,7546,3293,7546,3293,0,349
현대백화점,22003,4327,52,4327,52,0,141
현대슈퍼,43376,429,14,419,14,10,14
현대슈퍼,43617,0,138,0,138,0,4
현대시장,36042,9602,6493,9561,6493,41,519
현대시장,36043,7530,9393,7482,9393,48,545
현대시장,36118,7019,9053,6994,9053,25,518
현대써비스,42021,3672,2865,3672,2865,0,210
현대아파트,35396,372,18,372,18,0,12
현대아파트,37154,2822,7570,2822,7570,0,335
현대아파트,37161,6620,3354,6620,3354,0,321
현대아파트,39267,5444,5413,5433,5413,11,350
현대아파트,39271,5920,3330,5901,3330,19,298
현대아파트,40112,36008,28041,35994,28041,14,2066
현대아파트,40681,1650,7723,1650,7723,0,302
현대아파트,40682,8272,1309,8272,1309,0,309
현대아파트,40737,754,2568,754,2568,0,107
현대아파트,40788,37042,34606,37036,34606,6,2311
현대아파트,43082,93,520,93,520,0,19
현대아파트,43083,449,135,449,135,0,18
현대아파트.통진도서관,80135,197,782,197,782,0,31
현대아파트.통진도서관,80136,1313,171,1313,171,0,47
현대아파트105동,40734,101,862,101,862,0,31
현대아파트105동,40735,589,222,589,222,0,26
현대아파트113동,40105,10814,6455,10814,6455,0,557
현대아파트116동,40732,1698,330,1698,330,0,65
현대아파트119동,40733,87,2809,87,2809,0,93
현대아파트120동앞,40140,278,5095,278,5095,0,173
현대오일뱅크,41459,2358,1437,2358,1437,0,122
현대자동차빌딩앞,40103,6370,14812,6368,14812,2,683
현대자동차서비스,42032,10006,2841,9990,2841,16,414
현대자동차서비스,42033,13562,9531,13525,9531,37,744
현대제철,36086,496,1213,495,1213,1,55
현대제철,36123,2595,625,2595,625,0,103
현대제철정문,36133,490,1160,490,1160,0,53
현대철강레이져,90220,0,43,0,43,0,1
현대철강레이져,90221,28,0,28,0,0,0
현송중학교,38744,6560,2506,6560,2506,0,292
현송중학교,38745,3900,4589,3900,4589,0,273
형제마트,40004,487,1758,487,1758,0,72
형제마트,40006,1403,639,1403,639,0,65
혜덕,90217,6,4,6,4,0,0
혜성프라자,40393,22331,14464,22324,14464,7,1186
혜성프라자,40395,16846,17783,16839,17783,7,1117
호구포역,39784,6311,7584,6311,7584,0,448
호구포역,39785,10156,8780,10156,8780,0,610
호구포역2번출구,92040,1484,585,1484,585,0,66
호명사입구,40093,13,653,2,653,11,21
호박골,43437,44,27,42,27,2,2
호박골,43784,72,19,69,19,3,2
호박골사거리,43123,7,41,6,41,1,1
호박골사거리,43124,61,6,61,6,0,2
호박골사거리,43706,5,271,5,271,0,8
호박골사거리,43804,138,13,136,13,2,4
호반베르디움,42855,589,5080,589,5080,0,182
호반베르디움14단지,42880,1286,4004,1281,4004,5,170
호반베르디움214동앞,42998,188,776,188,776,0,31
호반베르디움2차,89112,1592,1222,1592,1222,0,90
호반베르디움2차,89113,1443,1268,1443,1268,0,87
호반베르디움3차아파트,42743,2759,7379,2759,7379,0,327
호반베르디움3차아파트,42908,1224,4842,1222,4842,2,195
호반베르디움아파트,39922,2735,866,2735,866,0,116
호반베르디움아파트107동,92011,4754,311,4754,311,0,163
호반써밋1차 3101동,89393,630,2612,630,2612,0,104
호반써밋1차 3101동,89394,1420,275,1420,275,0,54
호반써밋1차아파트,89472,942,489,942,489,0,46
호반써밋1차아파트,89473,1826,2440,1826,2440,0,137
호반써밋송도,38637,6026,259,6011,259,15,202
호반써밋송도(109동),38634,1527,2059,1527,2059,0,115
호반써밋스카이센트럴1차아파트,35892,247,664,247,664,0,29
호반써밋스카이센트럴1차아파트,35893,500,347,500,347,0,27
호불사입구,38180,2680,3167,2680,3167,0,188
호불사입구,38182,2904,2353,2904,2353,0,169
호세요양원,43221,14,138,14,138,0,4
호세요양원,43311,8,5,7,5,1,0
호수공원,89103,293,672,293,672,0,31
호수공원,89104,2652,670,2652,670,0,107
호수공원음악분수,89027,2326,1498,2326,1498,0,123
호수공원음악분수,89028,1244,2250,1243,2250,1,112
호수마을5단지후문,35270,56,50,56,50,0,3
호수마을5단지후문,35735,54,79,54,79,0,4
호수마을이편한세상.한가람우미린,80319,1166,515,1157,515,9,54
홈씨씨인천점,42955,19,290,18,290,1,9
홈씨씨인천점,42957,83,12,83,12,0,3
홈씨씨인천점,89188,545,717,545,717,0,40
홈플러스,80070,215,2810,215,2810,0,97
홈플러스,89225,764,490,764,490,0,40
홈플러스,35218,553,1568,553,1568,0,68
홈플러스.산림조합,80018,3071,132,3071,132,0,103
홈플러스계산점,41622,44,1507,44,1507,0,50
홍대입구역,23011,402,7139,402,7139,0,243
홍대입구역,23031,45772,653,45772,653,0,1497
홍대입구역,23032,419,19488,419,19488,0,642
홍예문·공영주차장,35794,11,408,11,408,0,13
홍예문·공영주차장,35806,51,316,51,316,0,11
홍의사거리,43798,59,50,57,50,2,3
홍의사거리,43813,14,33,14,33,0,1
홍의삼거리,43441,4,25,4,25,0,0
홍의삼거리,43613,64,44,62,44,2,3
홍익자원,35514,1187,600,1187,600,0,57
홍익자원,35515,40,944,40,944,0,31
홍현마을,90002,31,7,30,7,1,1
홍현마을,90003,7,35,7,35,0,1
화개사입구,90034,0,91,0,91,0,2
화개사입구,90035,103,3,101,3,2,3
화개정원,90405,29,113,29,113,0,4
화곡역,16147,48409,53912,48409,53912,0,3300
화도,43077,123,106,121,106,2,7
화도고개,36027,1741,2466,1727,2466,14,135
화도고개,36028,1682,4523,1674,4523,8,200
화도돈대,43676,39,7,39,7,0,1
화도돈대,43863,1,50,1,50,0,1
화도진공원.화도진도서관,36033,11054,3222,11021,3222,33,460
화도진공원.화도진도서관,36035,3576,11160,3558,11160,18,475
화도진중학교,36064,2997,805,2964,805,33,122
화도진중학교,36066,936,2939,927,2939,9,125
화도터미널,43104,1069,1374,1039,1374,30,78
화도터미널,43105,1403,687,1387,687,16,67
화력발전소,42628,203,295,203,295,0,16
화문석문화관,43452,0,21,0,21,0,0
화문석문화관,43697,1,0,0,0,1,0
화물터미널,35039,11,507,11,507,0,16
화물터미널,35040,290,31,290,31,0,10
화성보일러,39107,2854,5920,2854,5920,0,283
화성파크드림.스카이시티자이,35651,7559,2024,7557,2024,2,309
화성파크드림후문.한라비발디,35659,700,944,700,944,0,53
화수부두,36147,706,1559,696,1559,10,73
화수사거리,36072,2197,801,2170,801,27,96
화수사거리,36104,363,1256,360,1256,3,52
화전초교사거리,41087,920,1367,920,1367,0,73
화전초등학교,41085,1185,510,1185,510,0,54
화전초등학교,41086,582,686,582,686,0,40
화평철교.화평동냉면거리,36014,3449,3526,3431,3526,18,225
화평철교.화평동냉면거리,36016,16229,21875,16169,21875,60,1229
화훼단지,89489,9,7,8,7,1,0
화훼단지·당미교,41462,90,257,90,257,0,11
화훼단지·당미교,41463,64,158,64,158,0,7
환경공단강화사업소,90109,0,8,0,8,0,0
환경공단강화사업소,90110,0,34,0,34,0,1
황곡노인정,89310,53,0,51,0,2,1
황곡노인정,89320,116,138,107,138,9,8
황곡상회,89311,45,4,45,4,0,1
황곡상회,89330,2,41,2,41,0,1
황골,43992,13,51,13,51,0,2
황골,43993,70,8,67,8,3,2
황골마을,43135,16,11,16,11,0,0
황골마을,43277,10,1,10,1,0,0
황련사입구,43328,99,100,97,100,2,6
황련사입구,43630,49,0,49,0,0,1
황산도,43635,7,18,7,18,0,0
황산도관광밸트,43873,3,0,2,0,1,0
황산도관광밸트,43876,0,13,0,13,0,0
황산도입구,43636,38,10,38,10,0,1
황산도입구,43861,11,21,11,21,0,1
황청리종점,90207,2,0,2,0,0,0
효성2동치안센터,41024,1940,9062,1936,9062,4,354
효성고등학교,41074,1519,882,1504,882,15,77
효성고등학교,41075,670,2169,665,2169,5,91
효성남초등학교,41040,5652,2978,5650,2978,2,278
효성노인문화센터,41409,593,1762,593,1762,0,75
효성노인문화센터,41410,467,783,467,783,0,40
효성농협,41039,2793,1545,2771,1545,22,139
효성뉴서울아파트,41060,11731,1854,11715,1854,16,438
효성뉴서울아파트,41061,2382,13531,2368,13531,14,513
효성뉴서울아파트202동,41078,1980,16627,1980,16627,0,600
효성뉴서울아파트204동,41368,14165,1677,14165,1677,0,511
효성대신아파트,41041,5305,2826,5251,2826,54,262
효성대신아파트,41042,399,3863,396,3863,3,137
효성도서관,41420,2580,418,2580,418,0,96
효성동동화운수차고지,41573,8305,3528,8276,3528,29,381
효성명현초등학교,41065,3175,1165,3104,1165,71,140
효성사거리,41017,1051,5198,1050,5198,1,201
효성사거리,41018,10922,4624,10903,4624,19,501
효성사거리,41019,5183,5645,5171,5645,12,349
효성사거리,41631,807,869,806,869,1,54
효성상아아파트,39357,13872,16665,13851,16665,21,985
효성상아아파트,39358,18698,13362,18671,13362,27,1034
효성서초등학교,41557,3151,512,3151,512,0,118
효성서초등학교,41558,537,2840,537,2840,0,108
효성서초등학교,41579,184,704,184,704,0,28
효성서초등학교,41580,1676,521,1676,521,0,70
효성성모병원,41022,4745,209,4745,209,0,159
효성소방파출소,41023,8474,2898,8453,2898,21,366
효성신사거리,41030,1504,8063,1498,8063,6,308
효성신사거리,41031,7229,1497,7203,1497,26,281
효성아파트,42166,8905,2373,8905,2373,0,363
효성아파트,42168,2372,8192,2372,8192,0,340
효성중앙교회,41021,189,7257,189,7257,0,240
효성프라자,41052,11776,10005,11701,10005,75,702
효성프라자,41055,5906,6163,5859,6163,47,389
효성현대3차,41049,1427,3443,1405,3443,22,157
효성현대3차아파트,41051,814,528,801,528,13,43
효성현대4차,41035,2159,4475,2123,4475,36,214
효성현대4차아파트,41036,4291,1720,4262,1720,29,193
효자교앞,90199,4,3,4,3,0,0
효자교앞,90200,5,12,5,12,0,0
효정아파트,38260,1445,1875,1445,1875,0,107
후정초등학교.삼산도서관,40685,89,1393,89,1393,0,47
후지테크,39051,2058,1341,2058,1341,0,109
후지테크,39052,497,1971,497,1971,0,79
후포항입구,43431,12,90,12,90,0,3
후포항입구,43481,74,19,60,19,14,3
휴먼시아1단지,40837,3088,6565,3088,6565,0,311
휴먼시아1단지,40838,6180,1661,6180,1661,0,252
휴먼시아1단지,40840,913,3,913,3,0,29
휴먼시아1단지,40852,124,1969,124,1969,0,67
휴먼시아후문,42885,9231,3753,9231,3753,0,418
흥성리,18804,3,181,3,181,0,5
흥성리,62029,198,5,198,5,0,6
흥왕2리마을회관 앞,43122,34,65,34,65,0,3
흥왕2리마을회관 앞,43520,33,25,33,25,0,1
흥왕리,90073,1,6,1,6,0,0
흥왕리,90074,4,2,3,2,1,0
흥왕상회,43502,60,30,60,30,0,2
흥왕상회,43516,11,5,9,5,2,0
희경산업·남동스카이장례식장,39031,257,137,257,137,0,12
희경산업·남동스카이장례식장,39961,34,217,34,217,0,8
희망찬요양병원,38126,4892,7342,4892,7342,0,394
희망천입구,40091,5640,4373,5640,4373,0,323
희망천입구,40799,5373,5450,5373,5450,0,349
희망체육공원입구,40912,5346,47,5343,47,3,173
희성금속,42018,82,388,82,388,0,15
힐데스하임,42876,8343,2190,8343,2190,0,339
힐스테이트,35457,16732,10494,16725,10494,7,878
힐스테이트,35458,6459,4901,6459,4901,0,366
힐스테이트레이크송도(후문),38630,2223,1573,2223,1573,0,122
힐스테이트레이크송도(후문),38656,1596,1509,1596,1509,0,100
힐스테이트레이크송도1차입구,38655,974,1084,974,1084,0,66
힐스테이트레이크송도1차입구,38751,479,1019,479,1019,0,48
힐스테이트레이크송도2차(201동),38641,2219,2172,2219,2172,0,141
힐스테이트레이크송도2차(201동),38657,1656,1183,1656,1183,0,91
힐스테이트송도더테라스(정문),38715,1597,451,1597,451,0,66
힐스테이트송도더테라스(정문),38716,363,1177,363,1177,0,49
힐스테이트송도더테라스(후문),38713,2830,2653,2830,2653,0,176
힐스테이트송도더테라스(후문),38714,1154,2291,1154,2291,0,111
힐스테이트푸르지오주안,37293,35661,40881,35602,40881,59,2469
힐스테이트푸르지오주안아파트,37680,11437,12401,11430,12401,7,768
힐스테이트학익,37022,5989,5370,5982,5370,7,366
힐스테이트학익,37023,5137,7681,5131,7681,6,413
힐스테이트학익104동앞,37669,1560,1837,1560,1837,0,109
힐스테이트학익104동앞,37670,2681,4636,2681,4636,0,236
힐캐슬프라자,39329,12142,17984,12127,17984,15,971
힐캐슬프라자,39331,19895,10037,19876,10037,19,965
힘찬병원,40891,5451,7161,5434,7161,17,406
힘찬병원,40892,4071,2873,4065,2873,6,224
